aaa	aka
aaaa	away
aaaaa	alana
aaaaand	laaland
aaaages	manages
aaaah	sarah
aaaand	armand
aaah	ayah
aadam	madam
aaha	aha
aahh	aah
aan	can
aandoening	abandoning
aanrader	abrader
aanraking	pancaking
aao	ago
aardig	awarding
aare	are
aarke	are
aat	at
abdminal	abdominal
abdoment	abdomen
abdominals	abdominal
aber	amber
abiity	ability
abillity	ability
abit	bit
abituato	agitato
abituer	bitter
ablauf	ablaut
ables	able
ablke	able
ablo	able
abnormalites	abnormalities
abordar	border
abott	about
abour	about
about's	bout's
abouts	about
aboutta	about
abovementioned	aforementioned
absense	absence
absoluetly	absolutely
absolument	absolutest
absolut	absolute
absolutley	absolutely
absolutly	absolutely
absoluto	absolute
absoluut	absolute
abt	at
abuelo	angelo
abunda	agenda
aburpia	abulia
abv	abs
aca	act
acabei	caber
acc	act
acca	accad
acccess	access
acceder	accede
accentuer	accenture
accepte	accept
acceptible	acceptable
accesible	accessible
acci	asci
accidentall	accidentally
accidentaly	accidentally
acclimatised	acclimatized
accodental	accidental
accomodation	accommodation
accomodations	accommodations
accompagn	accompany
accross	across
acct	act
acctually	actually
accupressure	acupressure
accupuncture	acupuncture
accupuncturist	acupuncturist
accutane	accurate
accute	accuse
aceito	acuity
acepted	accepted
acetonide	acetone
achalesia	achalasia
acheive	achieve
achey	ache
achlasia	achalasia
acho	echo
achs	acts
acide	aside
acides	acids
acidez	aside
ack	back
acod	acid
acoording	according
acorde	code
acostada	acosta
acotar	actor
acpd	acid
acro	acre
acronymed	acronym
actie	active
actief	acting
activatng	activating
actualizo	actualize
actuall	actually
actuallt	actually
actualy	actually
actuel	actual
actully	actually
actupunture	acupuncture
acudi	audi
acudo	scudo
acupuntura	acupuncture
acupunture	acupuncture
acupunturist	acupuncturist
acutally	actually
adamson	damson
addam's	adam's
adderal	federal
addictif	addicted
addictively	additively
ade	are
adecdotes	anecdotes
adem	adam
adeno	aden
adentro	dextro
adepto	adept
aderal	deal
adhder	adder
adhdish	kaddish
adhesions	adhesion
adiva	diva
adivan	divan
admin	admit
admins	admits
adquired	acquired
adredaline	adrenaline
adres	dares
adressage	dressage
adressed	dressed
adressen	dressed
adresses	dresses
adue	due
adulta	adult
adulto	adult
adviced	advice
ae	a
aea	area
aeeophagia	aerophagia
aer	are
aerghs	weighs
aeroohagia	aerophagia
aerophagie	aerophagia
aerophasia	aerophagia
aeroplane	airplane
aeroplanes	airplanes
aesophagus	esophagus
aesthetician	esthetician
aesthetist	anesthetist
afab	arab
afabs	arabs
afb	aft
afdeling	feeling
afecta	affect
afew	few
affectors	effectors
affilated	affiliated
afgaat	afloat
afib	fib
afkeke	akee
afpr	afar
afriad	afraid
afrin	afrit
afs	as
afte	after
afterall	apteral
afternnon	afternoon
aftwards	awards
aftwe	after
afuera	after
afvente	avenge
afwul	awful
afyer	after
agai	again
againm	again
agains	against
agei	age
agente	agent
agggges	gaggles
aggresive	aggressive
aggressivly	aggressively
aggrevates	aggravates
agh	ago
aghh	agha
aghhh	agha
agin	again
agit	git
agitaed	agitated
agnoy	annoy
agol	ago
agonising	agonizing
agotador	agitator
agravante	aggravate
agravators	aggravator
agreeance	agreeable
agressive	aggressive
agrivate	private
agtritter	aglitter
aguanto	guano
ahaah	ahead
ahah	hah
ahaha	alpha
ahahah	hamah
ahev	ahem
ahh	ah
ahha	aha
ahhah	ahead
ahhg	hang
ahhh	ah
ahi	hi
ahm	am
ahmadi	ahmad
ahn	an
ahn's	ann's
ahold	hold
ahole	whole
ahora	hora
ahouldn't	shouldn't
ahout	about
ahsan	than
aia	air
aight	right
ailleurs	killers
aimlee	aimee
ainda	kinda
ainful	painful
ainsi	ain't
aint	ain't
aip	air
airbnb	airing
airbnbs	airbags
airburp	airburst
aire	are
aires	tires
airpipe	airline
airpods	airport
airr	air
airv	air
airvom	arvo
aise	raise
ajay	away
ajd	and
ajlm	all
ajo	ago
ajoutant	adjutant
ajouter	outer
ajuda	aura
ajudar	ajar
ak	a
akaik	again
akinator	aviator
akl	all
aknowledge	knowledge
ako	ago
aksing	asking
akst	aust
akward	awkward
alables	tables
alaikum	alarum
alao	also
alariz	alaric
alays	always
albicans	africans
albiet	albeit
alc	all
alcahol	alcohol
alchalasia	achalasia
alchohol	alcohol
alchoholic	alcoholic
alchoholism	alcoholism
alchol	alcohol
alco	also
alcool	alcohol
alcoolis	alcoholic
alcopops	alcohols
alcun	alcuin
aldi	ali
aldrig	aldrin
alegra	allegra
alegre	alert
aleksandrovic	aleksandrovsk
aleno	leno
aless	less
alessia	alyssa
aleve	alive
aleviate	alleviate
aleviated	alleviated
alexa	alex
alexandre	alexander
alfonsi	alfonso
alginates	alginate
algo	also
algu	alg
alguien	alien
algum	album
alguna	luna
algunas	algins
alguno	albino
algunos	albinos
alguns	algins
alicel	alice
alieve	alive
alil	all
alimentarios	alimentation
alimentos	aliment's
alis	alias
aliser	alive
alittle	little
alivia	olivia
aliviate	alleviate
aliviates	alleviates
alivio	alive
alk	all
alka	aka
alkohol	alcohol
all'ues	allies
alla	all
alle	all
allebei	alleged
alleen	allen
allen's	alien's
aller	alley
allerede	alleged
allergan	allergen
alles	alley
allez	alley
allgeric	allergic
allicin	illicit
allieviated	alleviated
alliums	allium
alliviate	alleviate
alliw	allow
alll	all
allll	allyl
alllll	allele
alllmost	almost
allmost	almost
allong	along
allready	already
allright	alright
alls	all
allsince	alliance
allso	also
allt	all
allts	all's
allvar	altar
allways	always
almeno	alien
almenos	aliens
almos	almost
almsot	almost
alnighters	lighters
alo	all
alors	aloes
alot	lot
alottt	lotta
alr	all
alread	already
alreay	already
alrighty	alright
als	all
alseep	asleep
alsmot	also
alsnog	also
alsof	also
alt	all
alterantive	alternative
alternatieven	alternative
alternatif	alternative
alternativen	alternative
alternativet	alternative
altfor	actor
althans	athens
althought	although
altijd	allied
altough	although
altri	altai
altro	alto
alts	acts
alucol	glycol
alvast	avast
alvesco	alfresco
alvor	alcor
alway	always
alwsys	always
ama	am
amaaazing	amazing
amab	arab
amanada	amanda
amas	mas
amazings	amazing
ambas	ambos
ambetter	abetter
ambi	ami
ambulatoire	ambulatory
amc	am
amd	and
ame	me
amenhorhea	amenorrhea
amens	amen
ameriben	american
americanos	americans
amerika	america
amerikada	americana
amfinally	finally
amh	am
amigables	amiable
amiright	alright
amirite	amrita
amit	admit
ammount	amount
ammounts	amounts
amongs	among
amout	about
amoxycillin	amoxicillin
ampcare	amparo
amped	camped
amper	amber
amt	at
amtrack	amtrak
amts	acts
amyway	anyway
anaesth	anapest
anaesthesic	anaesthetic
anaesthesiologist	anesthesiologist
anaesthesiology	anesthesiology
anaesthestic	anaesthetic
anaesthetia	anaesthetic
anaesthetised	anaesthetized
anaesthtlesia	anaesthesia
anaethetic	anaesthetic
analyse	analyze
analysed	analyzed
analysing	analyzing
analytics	analytic
ananda	amanda
anasesia	anastasia
anastatic	anastasia
anastesia	anastasia
anasthasia	anastasia
anasthesia	anesthesia
anasthesiologist	anesthesiologist
anasthestia	anesthesia
anasthethic	anesthetic
anasthetic	anesthetic
anaware	unaware
ance	once
ances	dances
anche	ache
ancious	anxious
andar	adar
andare	andre
anddd	and
andddd	added
anden	andes
ander	under
andere	andre
anderen	andersen
anderes	andres
anders	wanders
anderson's	andersen's
andersons	anderson
andet	andes
andning	landing
ando	and
andoscopy	endoscopy
andpai	andrei
andra	andrea
andrearg	andrea
ands	and
aneasthetic	anesthetic
aneasthetists	anaesthetists
anecdotale	anecdotal
anecdotica	anecdotic
anectodal	anecdotal
anerysm	aneurysm
anes	ones
anestesia	anesthesia
anesth	nest
anesthesias	anesthesia
anesthesic	anesthetic
anesthesie	anesthesia
anesthesist	anesthetist
anesthesized	anesthetized
anesthestic	anesthetic
anesthetiser	anesthetize
anesthetitists	anesthetists
anesthisiologist	anesthesiologist
anesthsia	anesthesia
anestisia	anesthesia
anethaesia	anesthesia
anethitist	anesthetist
anethsia	anesthesia
anexity	anxiety
anfang	infant
anfrage	average
angeles	angels
angin	angie
angloman	anglican
angstig	angst
angsty	angst
angustie	augustine
anhaling	inhaling
anichebe	achebe
anim	aim
aninals	animals
anithing	anything
anmc	and
anmoins	anoint
annan	anna
annars	annals
annat	anna
anni	anna
annother	another
annyoing	annoying
ano	and
anocdotally	anecdotally
anogenital	congenital
anomalo	anomaly
anomoly	anomaly
anorectal	anorectic
anos	ants
anosmic	anosmia
another's	anther's
anout	about
anoying	annoying
anses	asses
ansious	anxious
anstr	answer
answeres	answers
antagit	antacid
antagonise	antagonize
antar	altar
antectotal	anecdotal
antegrade	integrate
anteilig	anteing
anterograde	intergrade
anthesia	anthesis
antiacid	antacid
antiacids	antacids
antidepressiva	antidepressive
antidotally	anecdotally
antiemetic	antisemitic
antiemitic	antisemitic
antifaces	artifacts
antigas	antipas
antihistaminics	antihistaminic
antihistaminika	antihistaminic
antimicrobials	antimicrobial
antrag	antral
antwoord	atwood
antwort	artwork
anuloma	granuloma
anway	away
anways	always
anx	and
anxienty	anxiety
anxieux	anxious
anxiey	anxiety
anxiuos	anxious
anxuous	anxious
anybkdy	anybody
anybodys	anybody
anycase	encase
anyday	anyway
anyhoo	anyhow
anyones	anyone
anyting	anything
anytning	anything
anywho	anyway
ao	to
aoc	doc
aok	ask
aome	come
aoooo	voodoo
aot	not
aout	about
aouth	mouth
aoyagi	voyage
ap	a
aparente	parents
aparently	apparently
aparte	apart
apenas	arenas
apendicitis	appendicitis
aperistaltic	peristaltic
aperitivo	aperitif
aperol	patrol
aperto	apart
apertura	aperture
apesar	appear
apetite	appetite
aphagia	aphasia
api	ape
aplica	plica
aplication	application
aplogies	apologies
apneic	panic
apnoea	apnea
apnoeas	apneas
apointment	appointment
apointments	appointments
apologise	apologize
apologised	apologized
apologising	apologizing
apoyo	poo
app	ape
apparantly	apparently
apparnetly	apparently
appart	apart
appeler	appealer
appelied	applied
appelle	appellee
appena	append
appetising	appetizing
appiontment	appointment
appmnt	appoint
appmt	apart
appoiment	appointment
appointement	appointment
appointements	appointments
appointmenta	appointment
appointmet	appointment
appoitment	appointment
appologies	apologies
appox	apply
apppointment	appointment
appreciatie	appreciate
apprenant	appendant
appriciate	appreciate
approched	approached
approx	approve
apps	apes
appt	apt
appticiate	appreciate
appts	apts
apreciated	appreciated
aprender	render
aprendi	appendix
apres	acres
aprire	price
aprn	apron
aproach	approach
aprox	apron
aqu	au
aquainted	acquainted
aquatintances	acquaintances
aquellos	quells
aqui	aqua
aquired	acquired
araphagia	aerophagia
arbitarily	arbitrarily
areata	reata
aren	are
arenaz	arena
arent	aren't
argh	arch
arghh	argue
arick	trick
arised	raised
arly	early
armoury	armour
arn't	ain't
arnt	art
aroudn	around
aroun	around
arounds	around
arousals	arousal
arr	are
arrangiert	arranger
arrhythmias	arrhythmia
arrhythms	rhythms
arriba	arroba
arrivait	arrival
arrivare	arrive
arrivent	arrived
arriver	arrived
arrogancia	arrogance
arrota	arroba
arrotar	acroter
arrotos	arroyos
arround	around
arroz	arrow
arryhthmia	arrhythmia
arrythmia	arrhythmia
arse	are
arsehole	asshole
arseholes	assholes
arses	asses
arte	are
articial	artificial
articolo	article
artigos	artists
artsen	arisen
arviso	artist
arzt	art
asd	and
asf	as
asgard's	bastard's
ashama	asama
asheville	nashville
ashli	ashes
ashraff	ashram
asi	as
askdocs	asdics
askin	asking
aslong	along
asmr	asir
asmtha	asthma
aso	so
asophagus	esophagus
asparation	aspiration
asperate	aspirate
asperated	aspirated
asperger's	asperges
asperin	aspirin
assed	asked
assez	asses
asshat	assist
assim	assam
assitance	assistance
assosiate	associate
assosiated	associated
assumingly	assuming
assumung	assuming
assunto	assent
assurez	assure
asuch	such
asumir	amir
asurance	assurance
asv	as
asvised	advised
aswel	asked
aswell	swell
asy	as
async	sync
ata	at
atacid	antacid
atacids	antacids
atall	tall
atcha	datcha
ated	ate
atenci	agency
atend	attend
athiest	atheist
athlean	athlete
athleta	athlete
athletico	athletic
atl	all
atleast	least
atorara	atbara
atp	at
atr	at
atrac	attack
atrantil	atlantic
atrapado	arapaho
atreve	agree
atributed	attributed
att	at
attaches	attached
atteindre	attendee
attemps	attempt
attente	attend
attribu	attribute
atul	all
atx	at
aty	at
aub	rub
auch	much
auckland's	auckland
aucun	autumn
aucune	accuse
aud	and
audhd	adhd
audiologie	audiologist
auditable	suitable
auduible	audible
auf	au
aufkl	awful
aufst	aust
aufsto	auto
auh	uh
aujourd	adjourn
aukland	auckland
aulet	amulet
aumenta	augment
aunque	unique
aur	our
aurait	afraid
aussi	aussie
aussieht	aussies
aut	but
autant	mutant
auth	auto
authorisation	authorization
authorise	authorize
authorised	authorized
authorising	authorizing
auths	autos
automath	automate
automatiaclly	automatically
automaticaly	automatically
automod	automat
autopay	autopsy
autophony	antiphony
autoriza	authorize
autre	antre
aux	au
avaient	ancient
avais	avail
avait	await
avaler	dealer
avaliable	available
avanc	van
avance	advance
avancer	advancer
avances	advances
avant	savant
avarage	average
avec	ave
avendo	avenge
avenida	agenda
avere	avert
aversary	adversary
averson	aversion
avete	ate
avevo	avert
avez	ave
avg	ave
avialable	available
aviez	view
aviva	viva
avm	am
avoidant	avoiding
avoide	avoid
avoir	avoid
avoirs	avoids
avrai	afraid
avril	avail
avuto	auto
aw	a
awar	away
awarenesses	awareness's
aways	always
aweful	awful
awesone	awesome
awfulll	awfully
awfullll	awfully
awh	ah
awilkinson	wilkinson
awk	ask
awkard	awkward
awsy	away
aww	awe
awww	away
axa	axe
axiety	anxiety
axnieties	anxieties
ayad	ayah
ayan	ryan
ayce	ace
ayni	ani
ayo	ago
ayotunde	yaounde
ayres	acres
ayuda	aura
ayudan	yuan
ayudar	adar
ayude	aude
ayup	yup
ayurvedic	ayurveda
ayy	any
ayyy	any
az	a
azoles	azores
azucares	azures
baaa	baba
baaaad	ballad
baaad	baaed
baarn	barn
bab	bad
bably	baby
bacause	because
backburner	baseburner
backdraw	backdrop
backend	backed
backest	blackest
backflips	backflows
backpaddle	packsaddle
backpain	backpack
backrub	backup
backstep	backstop
backstory	backstop
backwashes	backlashes
badass	brass
baddd	baddy
badddd	added
baddly	badly
badgut	badge
badkwaids	backwards
bae	be
baha	bah
bahaha	bahama
bai	bad
bain	pain
baisser	blister
baja	baba
bajando	brando
bajar	ajar
bajaron	baron
baje	base
bajillion	bazillion
bakewell	farewell
bakhsh	bash
balen	bale
balle	ball
balletje	ballet
ballin	balling
ballonn	balloon
ballonnement	ballottement
balloob	balloon
ballparking	hallmarking
baloon	balloon
balzano	bolzano
bam	am
bananna	banana
banf	bank
bankart	banker
bao	bad
bapoa	papa
bara	bar
barcode	arcade
bareable	variable
barfy	barf
barhroom	bathroom
bariatric	barbaric
barista	batista
barnets	barnes
barral	barrel
barrasser	barrister
barratts	barretts
barret's	barrel's
barrets	barrels
barriga	barrier
barrium	barium
bartended	bartender
baryum	barium
bas	was
baselessly	carelessly
basians	asians
basicaly	basically
basiclly	basically
basicly	basically
basitan	basilan
basitan's	basilan's
basitian	basilian
baskin	basin
basmati	amati
bassie's	cassie's
bassy	bass
bastain	abstain
bastain's	bastian's
bastains	abstains
bastante	astarte
basten's	baster's
bastien	bastion
bastien's	bastion's
bastiens	bastions
bastin	basin
bastin's	basin's
baston	baton
basura	basra
bataille	braille
batian	batman
batla	bala
batrhoom	bathroom
batshit	catsuit
batsian	batsman
baustian	faustian
baving	having
baycare	daycare
baycare's	daycare's
bazillionaires	billionaires
bb	be
bbc	bic
bbl	bel
bbq	be
bbqs	bb's
bby	by
bc	be
bcak	back
bcbsnc	bcbs
bcbstx	bcbs
bcece	piece
bcos	cos
bcoz	coz
bcs	bus
bcuz	cuz
bcz	biz
bday	day
bdp	bop
beacause	because
beachball	blackball
beachy	beach
beacuase	because
beacuse	because
beadlets	beadle's
beardy	beard
beath	death
beatiful	beautiful
beause	because
beber	beer
bebida	beside
bec	be
becareful	careful
becase	because
becasue	because
becauce	because
becaue	because
becausw	because
becomming	becoming
becore	before
becouse	because
becuase	because
bedankt	besant
bedbound	rebound
bedore	before
bedre	bede
bedringen	bedridden
bedste	best
beeb	been
beeer	beer
beeing	being
beens	been
beercan	bearcat
beersies	berries
beetje	beetle
beetween	between
befire	before
befor	before
beggging	begging
begining	beginning
beginn	begin
begint	begin
beglium	belgium
begon	begin
begonnen	beginner
begr	beg
begrijp	begrime
beh	be
behandler	handler
behandling	handling
behaviour	behavior
behavioural	behavioral
behaviours	behaviors
behing	being
behov	below
bei	be
beiden	biden
beighton	brighton
beiing	being
bekannt	besant
bekends	depends
bekr	bear
belastung	blasting
belcher	belches
belchers	belches
belchin	belching
belchy	belch
beleave	bereave
beleive	believe
beleving	believing
belgi	belg
belgique	belgium
belive	believe
belived	believed
beliving	believing
belkeit	beckett
bellaso	bells
bellen	belle
belloso	bells
bellys	belly
belps	helps
beltch	belch
belzebu	beelzebub
bem	be
benbart	herbart
bende	bend
bene	been
benedryl	benadryl
benefiber	benefited
benefical	beneficial
beneficios	beneficial
benfits	benefits
benifit	benefit
benim	denim
benninger	cunninger
benoemd	bended
bentyl	benzyl
benzo	benz
beore	before
beps	beeps
ber	be
berall	befall
beraten	beaten
bereits	berets
bergeron	bergen
beriam	beria
bericht	bright
berichts	brights
berlier	berliner
berlina	berlin
berlinie	berlin
bernahme	bename
bernardino	bernardine
berverage	beverage
berverages	beverages
besked	bested
besloten	bespoken
beslut	best
besodes	besides
besoin	begin
besser	lesser
bestaan	bestial
bestaat	restart
beste	best
besten	beaten
bestest	fastest
bestfriend	befriend
bestian	bestial
bestie	bessie
besties	bestirs
bestilt	bestial
besv	best
betain	retain
betala	metal
betale	betake
betekent	betoken
beter	better
beti	bet
betoog	betook
betreft	bereft
beu	be
beung	being
beurt	blurt
beuwhen	beuthen
bev	be
bevause	because
bevs	bees
bevvys	bevvy
bexy	sexy
bez	be
bezahlen	befallen
bezahlt	bezant
bezig	being
bf	of
bf's	be's
bfa	bra
bfrb	barb
bfs	bus
bg	be
bht	but
bicarbonated	bicarbonate
biccups	hiccups
bichell	michelle
bidmc	bid
bien	been
bietet	bite
bifed	biked
bifida	bifid
biggg	big
biggy	piggy
bigish	biggish
bigs	big
biiig	being
biiiig	biting
biiit	bit
bij	big
bijdrage	birdcage
bijna	bin
bikhazi	bihari
bil	big
biletan	tibetan
biller	killer
billingham	birmingham
billlion	billion
bilt	bit
bilut	but
binarys	binary
bing	being
bingcang	binging
binnen	binned
bio	big
biocarbonated	bicarbonate
biochem	bitches
biomechanically	biomechanical
biomes	biome
bioposy	biopsy
biotics	bionics
bipap	bias
bir	big
birinin	bikini
birisi	birds
birkhead	dickhead
birthdate	birthrate
bish	wish
bisher	fisher
bismal	dismal
bismol	pistol
bisnol	pistol
bisschen	birchen
bist	best
bisuits	biscuits
bitix	bit
bitox	botox
bitoxin	toxin
bitsy	bits
bitties	titties
biy	by
bizar	bazar
bizzare	bizarre
bizzarre	bizarre
bj	be
bj's	be's
bjgger	bigger
bjj	be
bjs	bus
bkk	bk
bktox	botox
bl	be
bla	la
blabla	baba
blackhealth	blackheart
blackheath	blackheads
blahh	blah
blaoting	blasting
blargy	large
blas	blast
bldg	blog
ble	be
blech	bleach
bleches	belches
bleching	bleaching
bleek	bleed
blegh	bligh
bleh	blew
blehh	blew
blehhh	bleach
bleiben	leiden
bleibt	bleat
bleue	blue
blev	blew
bli	li
blij	blip
blijven	liven
blingen	bingen
blir	blur
blitt	blitz
blitzen	blitzed
blitzer	blitzed
blive	live
blivit	limit
bllurp	blur
bloatedness	belatedness
bloatening	broadening
bloaties	bloated
bloatiness	bleariness
bloatless	bloodless
bloaty	floaty
blocage	blockage
bloodwork	bloodworm
blop	blow
bloquer	blower
bloted	bolted
blowj	blow
blua	blue
bluecross	bluegrass
blumin	blaming
blurp	blur
bluuu	blue
bm	be
bmo	mo
bmp	bump
bms	bus
bnb	bob
bnsf	best
bo	to
boba	bob
bobas	bob's
bodys	body
bodyshot	bodysuit
boeit	best
boeken	been
boekte	bookie
boeren	been
boffed	offed
boheme	theme
boht	both
boi	boy
boire	bore
bois	boys
boissons	soissons
boka	bona
bokat	boat
bolded	folded
bolemia	bohemia
bolingbrook	bolingbroke
bollocksed	bollocks
bonine	boning
bonjour	contour
bonnes	bones
boof	book
bookended	bookend
bookending	bookbinding
booo	book
boox	book
bor	for
borborygmi	borborygmus
borde	border
borelli	corelli
borland	norland
bornal	boreal
borrel	barrel
borrelli	bordello
borrels	barrels
borte	bore
bosna	bona
bosstones	boston's
bot	not
botad	bad
botar	boar
botax	borax
boted	bored
botex	botel
botix	botox
boto	both
botolium	botulism
botow	botox
botox'd	botoxed
botox'ed	botoxed
botox's	book's
botoxem	botoxed
botoxen	botoxed
botoxer	botoxed
botoxers	bothers
botoxing	boxing
botoxt	botox
botoxulin	botulin
botoxx	botox
botoz	botox
bottox	bottom
botulinim	botulinum
botulino	botulin
botulique	boutique
botullinum	botulinum
botx	both
bouch	touch
bouche	douche
bouge	gouge
bouger	booger
boujee	bounce
bouldering	bordering
boulot	boult
boutta	outta
boven	oven
boxox	botox
boxtox	botox
boyles	boyle
boyox	botox
boytle	bottle
bozeman	foreman
bp	be
bpd	bad
bph	bah
bpp	bop
bppv	bop
bptoc	optic
bpv	bpm
brabois	rabbis
braggy	baggy
brah	bra
braindead	branded
brainer	trainer
brainspotting	trainspotting
brainstem	brainstorm
bralette	brunette
bralettes	brunettes
brandawg	branding
brashes	crashes
brasileiro	brasilein
brasilians	brazilians
brassicas	brassica
braucht	brought
breadless	headless
breadlike	breadline
bready	ready
breahhe	breathe
breahting	breathing
breakingly	breaking
breakpoint	breakpoints
breakroom	breadroot
breaksfast	breakfast
breanne	breathe
breaskfast	breakfast
breatbing	breathing
breatheee	breathe
breathibg	breathing
breathin	breathing
breathness	breathless
breathnessless	breathlessness
breathwork	breastwork
breezers	breezes
bref	brief
breif	brief
breifly	briefly
brekkie	trekkie
brekky	break
breo	bred
brev	bred
brewry	brewery
brewski	brews
brewskis	brewis
brexit	credit
bridgerton	bridgetown
bridgeton	bridgetown
briebd	bribed
brightside	rightsize
bringt	bring
brissi	crisis
brissy	prissy
bristow	bristol
brita	brits
britse	brits
britta	britt
bro	pro
broblem	problem
broca's	brock's
broccolini	broccoli
brokke	broke
bromelain	bromeliad
bronchoscopies	bronchoscopes
broo	broom
broodjes	broods
broomfield	bloomfield
brooo	broom
brooooo	booboo
broski	broke
brotha	broth
brothy	broth
brough	brought
brrrr	error
bru	bra
brudi	bride
brug	drug
bruh	brush
brul	bul
brulee	rule
brunswicker	brunswick
brup	burp
bruped	burped
brups	burps
brusells	brussels
brusher	brushed
brussel	brussels
bruvsmell	brummell
bruxism	bruise
bryson	bryon
brystet	brisket
bs	is
bsbell	sell
bscs	bs's
bsite	bite
bsstie	bustle
bst	but
bsw	bow
btdt	but
bu	be
bua	but
bubbels	bubbles
bubblies	bubbles
bubblings	bubbling
bubles	bubbles
bublr	buber
bubly	bully
buch	much
buckmire	backfire
budda	buddy
buddys	buddy
buen	been
buena	bueno
buenos	bueno
buf	but
bugbaby	bugbane
buh	but
buik	buck
buis	bus
buisness	business
buitenland	burgenland
bukus	bus
buldum	buildup
bulemic	bulimic
bullemic	bulletin
bulp	bump
bumpyness	bumpiness
bunping	bumping
bunun	bunin
buona	bona
buono	bono
bup	but
bupa	pupa
bupff	buff
bupr	burp
bupring	burping
burb	burn
burbed	buried
burber	burger
burbers	burgers
burbing	burning
burbt	burnt
burgerking	burgeoning
burgmann	bergman
burmping	bumping
burny	burn
burpa	burp
burpability	culpability
burpables	burnables
burpage	burbage
burpbut	burnout
burpd	burp
burpday	burpy
burpdem	burden
burpderps	burpers
burpees	burpee
burper's	burger's
burpersw	burpers
burpes	buries
burpettes	burettes
burpfree	burpee
burpgang	burping
burpgery	surgery
burpier	bumpier
burpies	buries
burpin	burping
burpinator	buccinator
burpiness	bumpiness
burping's	burping
burpings	burping
burpish	burnish
burpking	burping
burple	purple
burples	purples
burpless	purples
burplife	surplice
burplike	birdlike
burpling	burping
burpmas	burps
burpness	business
burpped	burped
burppies	puppies
burppp	burp
burpring	burping
burpside	burnside
burpung	burping
burpyness	bumpiness
burried	buried
burritoed	burrito
burrother	brother
busca	busch
buscar	scar
buscate	obfuscate
buspar	bumper
butchy	bitchy
butes	bites
buteyko	buteo
buti'm	autism
butp	but
butping	bumping
butps	butts
butso	buts
butteeflies	butterflies
butthead	bulkhead
buttheaded	bullheaded
butthole	bunghole
buttholes	boltholes
buttload	boatload
buttt	butt
butttt	butt
butyric	butyrin
buub	bulb
buurt	blurt
buutt	butt
buuullshit	bullshit
buuut	butut
buuuut	buyout
buyed	buyer
buzzfeed	buzzed
buzzy	buzz
bvi	bi
bvi's	bi's
bvis	bis
bw	be
bwahaha	bahama
bwh	bah
bwing	being
bx	be
bydr	byrd
byeeee	breeze
byo	by
byt	but
c'est	chest
c'mon	cimon
cabeza	camera
cabonated	carbonated
cabonation	carbonation
cacl	call
caco	taco
cada	casa
cadbury	banbury
caderas	cameras
cae	can
caesin	casein
caf	can
cafe	came
cafes	cares
caffier	chaffier
caffine	caffeine
calcifications	calcification
calibre	caliber
calippo	calico
calistenics	calisthenics
calpol	call
calpro	carlo
cals	call
calvario	calvaria
cambiado	cambia
cambias	cambia
cambio	cambia
camhs	camps
camillus	camilla
camogie	calorie
campbell's	campbell
can'y	can't
canap	canal
cancelations	cancellations
candada	canada
canditate	candidate
canette	cadette
cannnnn	cannon
canshow	anyhow
cant't	can't
canular	cannular
cany	can
capacit	capacity
capaz	cap
capitalise	capitalist
capitalising	capitalizing
capito	capitol
capn	can
caprese	cares
capsulss	capsules
capte	cape
carafate	carafe
carays	carats
carb	care
carbinated	carbonated
carbobation	carbonation
carbonators	carbonados
carbondated	carbonated
carbonised	carbonized
carbotaned	carbonated
carbs	cars
carby	carry
carciopharyngeal	cricopharyngeal
cardia	cardiac
cardias	cardiac
cardio	cardie
cardonated	carbonated
carefirst	careerist
carefuly	careful
careing	caring
careul	careful
carfeful	careful
carfull	careful
carinatum	carinate
carlee	carlene
carnaval	carnival
carnist	carlist
carnitas	caritas
carobated	carbonated
carrabba	carnauba
carreers	careers
carrera	barrera
carrol	carrot
carseat	carpet
cartillage	cartilage
cartoonishly	cartoonish
cas	was
casd	case
cashback	flashback
cashpay	sashay
casi	case
caso	case
casos	cases
catagory	category
catani	catania
catastrophise	catastrophism
catastrophize	catastrophic
catathronia	catatonia
categorised	categorized
catscan	vatican
catsos	fatsos
caues	cause
caugh	caught
causa	cause
causaba	casaba
causations	causation
causings	causing
cava	cave
cavaty	cavity
cbc	cb
cbd	cod
cbg	cog
cc	ca
cc's	ac's
ccg	cog
ccgs	cogs
ccing	cling
ccs	cos
cdc	cd
cdi	di
cdmx	come
cdn	can
cdp	cop
cdphp	caph
cdt	cut
cearly	early
ceaser	cease
cebolla	ebola
cebollas	cedillas
cec	ce
cej	ce
cel	cell
cela	cell
celahir	clair
celcius	celsius
celer	celery
celexa	celery
celiac's	celia's
celiaco	celiac
celiacs	celiac
celle	cell
cellulase	cellulose
celui	celli
cembre	member
cemment	comment
cena	cent
cenar	cedar
centimetre	centimeter
centimetres	centimeters
centralise	centralize
centre	center
centre's	center's
centred	centered
centrelink	centreing
centres	centers
centro	cento
ceo	ce
ceos	cos
cependant	dependant
ception	caption
cera	era
cera's	era's
cerave	crave
cerca	circa
cercle	circle
cerrain	certain
certaine	certain
certaines	certainly
certains	certain
certian	certain
certo	cento
cerveau	cereal
cervello	cervelat
cervezas	cervelat
ces	yes
cet	get
cette	bette
cevap	crap
ceylan	ceylon
cfa	ca
cfc	cf
cfs	cos
cfu	cu
chaged	changed
chai	chair
chakra	chair
chakras	chairs
challange	challenge
challenege	challenge
chama	champ
chamada	chamade
chamar	chadar
champignones	champignon
chanceux	chance
changingly	changing
chante	change
chaque	claque
characterised	characterized
charbon	carbon
charcocaps	charcoals
charit	charity
charite	charity
charset	charge
chattdx	chatter
cheadle	cradle
chears	cheers
chechia	czechia
checkbox	checkbook
cheecks	checks
cheesburger	cheeseburger
cheesey	cheese
cheeto	cheetos
cheez	cheer
cheeze	cheese
cheezit	cheerio
cheezits	cheerios
cheezy	cheeky
cheif	chief
cheliosis	helios's
cheln	chen
chemistries	chemistry's
chenj	chen
cheonic	chronic
cheque	cheese
cherch	church
chers	cheers
ches	chest
chetan	chetah
cheung	chung
cheval	coeval
chewables	chewable
chey	they
chh	chi
chheda	chaeta
chhedda	cheddar
chia	chip
chiacgo	chicago
chiari	chari
chicagoland	chicagoan
chickn	chicken
chico's	chick's
chicos	chicks
chikld	child
childfree	children
childhool	childhood
children's	children
childrens	children
childs	child
chillin	chilling
chillis	chills
chillled	chilled
chiropactic	chiropractic
chiropracter	chiropractor
chistes	whites
chitkara	cithara
chlich	which
chlorogenic	chromogenic
chobani	cobain
chocia	choice
chocke	choke
choclate	chocolate
chocolat	chocolate
choix	choir
chokey	choke
cholic	colic
chonic	chronic
choo	chop
choosed	choose
choroby	choosy
choses	chose
chota	chita
chouette	coquette
chricopharangeal	cricopharangeal
chricopharangeus	cricopharyngeus
chricopharyngeal	cricopharyngeal
chricopharyngeus	cricopharyngeus
christer	christen
christophi	christophe
chron's	charon's
chrones	thrones
chroniv	chronic
chrons	chron
chs	cos
chsten	chasten
cht	cut
chte	cute
chts	cuts
chu	chi
chugger	chugged
chuggin	chugging
chungus	chung's
churps	chirps
chuuu	chuck
chyba	chiba
cial	dial
cialis	calls
cialistes	ciliates
cichon	icon
cicp	nice
cicroid	cricoid
cicumstances	circumstances
cidos	ciaos
cierto	cicero
cieux	lieu
cigg	cig
ciggerettes	cigarettes
ciggies	piggies
cigna	sign
cigna's	signals
cigs	pigs
cil	oil
ciles	miles
cilinc	clinic
cinci	cinch
cincinatti	cincinnati
cinco	cinch
cincy	cinch
cio	co
cipo	ciao
circoid	cricoid
circopharangeal	cricopharangeal
circopharangyeal	cricopharangeal
circopharingeal	cricopharangeal
circopharynegeus	cricopharyngeus
circopharyngeal	cricopharyngeal
circopharyngeus	cricopharyngeus
circulo	circle
circumferentially	circumferential
circumfrence	circumference
circumstancws	circumstances
cirug	drug
cirurgy	liturgy
cis	is
cisions	visions
citerede	catered
citracel	citadel
citrics	citric
citrucel	citruses
citrusy	citrus
ciudad	caudad
civilisation	civilization
cjs	cos
ck	ok
cked	caked
cking	king
cklich	click
cklicher	clicker
cktes	cites
claggy	craggy
clapham	chatham
claritin	clarity
classof	class
clavicule	clavicle
cleanbum	cleanup
clearence	clearance
cleary	clear
clencher	clenched
clesrs	clears
clich	click
cliche	cloche
cliches	clinches
clicical	clinical
clicky	clicks
clientele	clientèle
clif	clip
clinc	clinic
clinica	clinic
clininc	clinic
clinique	critique
clinque	clique
clive's	olive's
cloating	floating
clomid	closed
closd	close
closey	close
cloused	closed
clues's	clue's
clurb	club
cmc	cm
cmon	con
cms	cos
cmyk	my
cna	can
cnd	and
cnica	nice
cns	cos
cny	any
cocodona	cocoon
codings	coding
codos	codes
coeliac	celiac
coeliacs	celiac
cofactor	factor
coffe	coffee
coffeine	caffeine
coincidentlaly	coincidentally
coinsurnace	coinsurance
coise	noise
colace	solace
colega	college
coli	cold
coliac	colic
coliky	colicky
coll	call
collegen	college
collegue	college
coller	collar
collett	collect
collicky	colicky
colono	colony
colonosocpy	colonoscopy
colour	color
colours	colors
columbo	colombo
comand	command
combi	comb
combien	combine
comenc	come
coment	moment
comenta	momenta
comenz	come
comething	something
comeup	come
comfortability	conformability
comida	coming
comidas	comics
comiera	camera
comin	coming
comingling	commingling
comiserating	commiserating
comm	come
comme	come
commenc	comment
commenters	commenter
commenti	comment
commentor	commenter
comming	coming
comminity	community
comms	comes
commun	common
communaut	communist
communo	commune
comorbid	morbid
comp	come
companys	company
compari	compare
compartir	compactor
compl	compel
complan	complain
compleet	complete
completar	completer
completelly	completely
completey	completely
completly	completely
completo	complete
complicado	complicate
complicator	complicated
compliqu	complied
complixated	complicated
compltely	completely
comportamento	comportment
comprend	compared
comprends	compounds
compris	comprise
compromiso	compromise
compu	comps
comrbid	forbid
comse	come
comsuming	consuming
comt	come
comunit	count
comunity	community
comunque	communique
conceptualise	conceptualize
concerete	concrete
concernant	concerning
concerne	concerned
concerta	concert
concidered	considered
concious	conscious
conciously	consciously
conciousness	consciousness
concrats	congrats
condi	condo
condici	conduct
condiciona	condition
condiciones	conditions
condiiton	condition
conditie	condition
conditon	condition
condtant	constant
conection	connection
conf	con
confering	conferring
confian	confirm
confiant	confidant
confirme	confirm
confortable	comfortable
confuss	confess
congee	conger
congential	congenital
congratsss	congrats's
congratualtions	congratulations
congratulatiooons	congratulations
congratz	congrats
congrayz	congrats
conhece	connect
conidition	condition
conmigo	consign
conming	coming
conna	gonna
connaissance	reconnaissance
connectoin	connection
connectted	connected
connues	continues
conocer	concern
conocido	conoid
conoloscopy	colonoscopy
conozco	orozco
conpletely	completely
conpression	compression
conrol	control
consanly	constantly
consciente	conscience
consecuence	consequence
consegu	consent
consegue	conserve
conseille	corneille
consejos	consents
consenso	nonsense
consentrated	concentrated
consetino	consenting
consicuences	consequences
consid	conoid
consigo	consign
consigue	continue
consigues	continues
consious	conscious
consipation	constipation
consistancy	consistency
consistant	consistent
consistantly	consistently
consisten	consistent
consistenly	consistently
consistens	consistent
consitency	consistency
consoltation	consolation
consomm	consommé
constation	consolation
constiaption	constipation
constinancy	constancy
constipatoin	constipation
constiptation	constipation
constitpation	constipation
constricton	constrictor
constulant	constant
consulation	consolation
consulta	consult
consultaion	consultation
consultantion	consultation
consultas	consults
consulter	consulted
consulto	consult
consultstion	consultation
consultstuon	consultation
consumir	consumer
cont	count
conta	conga
contacter	contacted
contactless	contextless
contacto	contact
contando	contango
contantly	constantly
contar	costar
contarles	constables
contarte	contact
contato	contact
contatti	contact
contatto	contact
contente	content
contin	contain
contine	continue
continouisly	continuously
continously	continuously
continu	continue
continuez	continue
continuos	continues
contipation	constipation
contiune	continue
contr	contra
contraire	contrary
contrario	contrary
contre	contra
contriversal	controversial
controlable	controllable
controle	control
controll	control
controloc	control
contuously	continuously
conveniente	convenient
convenieny	convenient
convered	covered
conversar	converse
convertirse	convertible
convice	convince
conviced	convinced
convincer	convince
convincere	convince
convo	convoy
convos	convoy
cooberate	cooperate
coocking	cooking
cooldown	comedown
cooncidentally	coincidentally
coordonn	cordon
coorelated	correlated
coorelation	correlation
coouuld	could
copays	copals
copd	cold
copeable	copyable
copiloted	copilot
copypasting	copycatting
corden	cordon
coreners	corners
cornhole	wormhole
corporales	corporals
corporelle	corporeal
correcly	correctly
correlationand	correlational
correspondaient	correspondent
corriger	corridor
corruptuons	corruptions
cosa	cost
cosas	costs
cosentino	consenting
cosmo	cosmos
costo	cost
cou	you
coudl	could
coudln't	couldn't
coue	come
cought	caught
coughy	cough
couidn't	couldn't
could'nt	couldn't
could't	couldn't
could've	would've
coulda	could
couldn	could
couldnt	couldn't
couldve	could
coule	could
coulod	could
counciling	counseling
cound	could
counscious	conscious
counselling	counseling
countertop	countertype
countrys	country
courant	courante
cours	course
couse	course
coust	count
cout	out
coute	cute
couter	outer
couvert	covert
couvrir	courier
cov	cop
covid	bovid
cp	up
cpam	cam
cpap	crap
cpc	cpl
cpd	cod
cpd's	cad's
cpder	cider
cpder's	ceder's
cpders	coders
cpe	cope
cph	ph
cpm	com
cpr	car
cprd	card
cpst	cost
cpt	cut
cptsd	cuts
cpuple	couple
craaazy	crazy
cracher	cracker
cracopharangeal	cricopharangeal
cradit	credit
crains	brains
crampy	crappy
cran	can
cranio	crania
crans	cans
crapload	carload
crapton	clapton
crazyyy	crazy
crd	card
cre	are
crea	area
creamline	streamline
creat	great
crecen	green
crecer	prefer
creeking	creeping
creeky	creepy
creeped	creeper
creo	crew
crepitus	credits
crhycopharangeal	cricopharangeal
criar	friar
criaram	trigram
cric	crib
criccoid	cricoid
crichopharangeal	cricopharangeal
cricioids	cricoid
cricipharyngeal	cricopharyngeal
crico	crick
cricofaryngeus	cricopharyngeus
cricoidal	cricoid
cricoids	cricoid
cricoparhyngeal	cricopharyngeal
cricophangeal	cricopharangeal
cricopharangeous	cricopharyngeus
cricopharangeus	cricopharyngeus
cricopharengeal	cricopharangeal
cricopharengeus	cricopharyngeus
cricopharengial	cricopharangeal
cricopharingeal	cricopharangeal
cricopharnageal	cricopharangeal
cricopharngeal	cricopharangeal
cricopharnygeal	cricopharyngeal
cricopharungeus	cricopharyngeus
cricopharygeal	cricopharyngeal
cricopharygenus	cricopharyngeus
cricopharygeues	cricopharyngeus
cricopharygeus	cricopharyngeus
cricopharyngeas	cricopharyngeal
cricopharyngel	cricopharyngeal
cricopharyngeous	cricopharyngeus
cricopharyngial	cricopharyngeal
cricopharyngus	cricopharyngeus
cricopharynxgeus	cricopharyngeus
cricophayngeus	cricopharyngeus
cricophyarngeal	cricopharangeal
cricophyarngeus	cricopharyngeus
cricophyrangeus	cricopharyngeus
cricophyrengeal	cricopharangeal
cricyphayngeus	cricopharyngeus
cridoid	cricoid
criei	cried
cringey	cringe
cringy	clingy
criocopharyngeus	cricopharyngeus
cripply	cripple
criroid	cricoid
cris	cries
criss	cross
cristo	crisco
crit	crib
criticise	criticize
crits	cries
crna	cana
croack	crack
croackers	crackers
croacking	cracking
croacks	cracks
croakes	croaked
croakey	croaked
croakin	croaking
croakman	croatian
croan	crown
crockes	crocked
crocoid	cricoid
crohn	crown
crohn's	crown's
crohnes	crones
crohns	crowns
crois	cross
croit	croft
croix	cross
croixs	cross
crokes	crores
croking	cooking
cronic	chronic
crossfit	crossfire
crosspost	crossest
croutons	crotons
crp	cop
crpd	crud
crps	cops
cruciferus	cruciferous
crup	cup
crurgle	crumble
crurgles	crumbles
crurgling	crumbling
cryco	cry
crycoid	cricoid
crycopharageal	cricopharangeal
crycopharangeal	cricopharangeal
crycopharangeus	cricopharyngeus
crycopharengeal	cricopharangeal
crycopharnygeal	cricopharyngeal
crycopharyngeal	cricopharyngeal
crycopharyngeus	cricopharyngeus
crystallised	crystallized
csak	cask
csas	was
csid	sid
csm	com
csnt	cent
csps	cops
css	ass
cst	cut
cthulu	cthulhu
ctica	utica
ctm	com
ctrl	curl
cts	its
cual	coal
cuando	candy
cuantas	canvas
cuanto	canto
cuarto	quarto
cuase	case
cubrir	cubic
cuenta	cuenca
cuentas	cents
cuerpo	curio
culo	cult
culpeper	curlpaper
culturelle	culturally
cum	cut
cunniligus	cunnilingus
cupples	cupules
curado	cured
curan	cuban
curarci	curari
cureable	curable
curee	cure
curieux	curious
curiosit	curiosity
curiositiy	curiosity
curioso	curios
curiousity	curiosity
curp	cup
curping	cursing
curps	cups
currentl	current
currentmy	currently
cus	us
cusack	crack
cuse	use
cushings	cushing
cusm	cuss
customised	customized
cux	cut
cv	ca
cvs	cos
cymbalta	cymbals
cypro	cipro
cz	ca
cze	cue
czego	zero
czekam	cream
czsk	cask
d'ailleurs	dérailleurs
d'aller	smaller
d'apr	dear
d'autant	débutant
d'avoir	devoir
d'capos	capos
d'effets	deffest
d'entre	denture
d'inject	inject
d'ondes	drones
d'orl	door
d'un	dun
d'une	dune
d'unit	unit
d'y	day
da	a
daaamn	damn
daal	deal
daar	dear
daaraan	dardan
daarna	dharna
dabei	dare
dacotor	doctor
dae	day
daf	day
dafoe	defoe
dagar	agar
dagbog	dago
dage	dare
dagen	hagen
dagens	agent
dailey	daily
daj	day
dajcie	dance
dal	day
dalek	dale
dallo	dally
daly	day
damaris	damars
damit	admit
damm	damn
damnit	dammit
dampet	damper
danach	banach
dandurff	dandruff
danelion	dandelion
dangereuse	dangerous
dangereux	dangerous
danggg	danger
dangit	danger
daniero	danger
dankbar	akbar
danke	dance
dankje	dance
danmark	denmark
dann	damn
dans	days
dansk	dank
danske	dance
danskere	danker
dar	day
daren't	aren't
darf	dark
darkk	dark
darm	dark
darnborough	marlborough
darndest	darnedest
darunter	drunker
das	was
dass	days
dat	at
datas	data
datis	dates
dats	days
daugher	daughter
daugter	daughter
dautre	dare
davantage	advantage
davon	damon
dawg	dawn
dax	day
daya	day
daylio	dahlia
dayquil	nyquil
dazs	days
dazu	daze
dbf	db
dbr	dir
dcd	did
dcf	cf
dcfr	car
dci	di
dd	do
ddz	adz
dea	dead
deaconness	deaconess
deadass	dead's
deadbugs	bedbugs
deadlift	deadline
deadlifts	deadliest
deala	deal
debatably	debatable
debatir	debater
debe	debt
deben	eben
debiliatitng	debilitating
debilitaiting	debilitating
debilitante	debilitate
debiltating	debilitating
debloat	bloat
debloated	bloated
debo	debt
debout	debut
debry	derby
decarbolized	decarbonized
decemver	december
decid	decide
decida	decide
decin	devin
decins	decide
decir	decor
decirle	decile
decontracting	contracting
dedos	demos
deductable	deductible
deductables	deductibles
deeb	deep
deeeep	deep
deegre	deere
deets	meets
def	de
defeinitely	definitely
defence	defense
defences	defenses
defenitely	definitely
defenitly	definitely
deff	deaf
deffff	decaff
deffo	deaf
deficienct	deficiency
defien	define
definately	definitely
definently	eminently
definetely	definitely
definetley	definitely
definetly	definitely
definietly	definitely
definintely	definitely
definitaly	definitely
definitiv	definitive
definitivo	definitive
definitley	definitely
definitly	definitely
defintely	definitely
defintion	definition
defintly	defiantly
defitniely	definitely
defizz	define
deflat	defeat
deflatine	deflating
defn	defy
defo	defy
defs	defy
deg	dog
deglution	delusion
deglutizione	deglutition
dehabilitated	rehabilitated
dehabilitating	rehabilitating
deine	define
deinem	denied
deiner	diner
deinking	drinking
dej	de
deja	dena
dejando	demand
dejar	dear
dejara	dear
dejarlo	dearly
dejas	degas
deje	dee
dekinks	drinks
deletado	deleted
delevop	develop
dello	hello
delt	felt
demain	remain
demande	demand
demi	demo
demom	demon
demonio	demonic
demonise	demonize
demoralised	demoralized
demoralising	demoralizing
denk	deny
denken	denied
denkt	dent
denn	deny
denna	donna
denne	dense
dentro	dextro
denverite	dendrite
deodenum	duodenum
deos	does
deosnt	doesn't
depeession	depression
deper	deeper
depois	depots
depresi	depress
depresser	depressed
depressurise	depressurize
deprssions	depressions
dept	kept
depuis	deputy
der	her
deras	dears
derfor	perform
derimot	deimos
derm	term
derni	terni
dernier	denier
des	does
descibe	describe
descibed	described
descreet	discreet
describir	describer
descript	rescript
descrption	description
descubr	rescuer
desde	dead
desease	disease
deseases	diseases
desensitisation	desensitization
desensitise	desensitize
deseo	desex
deseperately	desperately
desicion	decision
desidia	basidia
desilva	silva
desilvia	silvia
desinfect	disinfect
desn	desk
desnoods	snoods
desolved	resolved
desparate	desperate
desparately	desperately
despared	despaired
desperating	desperation
desperatly	desperately
despited	despite
despu	deep
desse	dense
destijds	desmids
destin	destiny
destress	distress
destressing	distressing
desv	desk
det	get
detailled	detailed
detalhes	detaches
detalis	details
detecto	detect
determinar	determiner
detroyed	destroyed
detta	delta
dette	bette
deutche	dutch
deutsch	dutch
deux	deus
deuxi	deli
dev	de
devais	devil
devait	devil
develoepd	developed
developped	developed
devenir	deventer
devestated	devastated
devo	demo
devolopment	development
devolped	devolved
devrait	derail
dewji	dew
dexilant	deviant
dexilent	exigent
deze	dee
df	of
dfq	of
dfw	dew
dgbi	dig
dgl	del
dgst	dust
dh	do
dha	ha
dhar	dear
dhewing	chewing
dhsc	disc
dia	did
diaease	disease
diag	dig
diagn	dian
diagnoesed	diagnosed
diagnoosin	diagnosis
diagnos	diagnose
diagnosably	diagnosable
diagnosen	diagnosed
diagnosticable	diagnostically
diagnostico	diagnostic
diagnosticos	diagnostics
diagphragm	diaphragm
diagphragmatic	diaphragmatic
diagphram	diagram
diahrea	diarrhea
diahrrea	diarrhea
diakonale	diagonal
dialate	dilate
dialated	dilated
dialation	dilation
dialators	dilators
dialled	dialed
diamity's	dimity's
diapgragm	diaphragm
diaph	death
diaphraghm	diaphragm
diaphragmic	diaphragm
diaphram	diaphragm
diapraghm	diaphragm
diapragm	diaphragm
diarea	dare
diarhea	diarrhea
diario	dario
diarrea	diarrhea
diarreah	diarrhea
diats	dials
diazapam	diazepam
dibetes	diabetes
dibiliating	debilitating
dibilit	debility
dibilitating	debilitating
dibles	bibles
dica	dick
dicas	dicks
dicaux	dictum
dicen	dice
dich	rich
dicho	rich
dicht	dicot
dicklin	tickling
dico	dick
dicos	dicks
dictamine	dictating
did'nt	didn't
did't	didn't
diddy	daddy
didi	did
didja	did
didn	did
didn''t	didn't
didnot	didn't
didnt	didn't
diese	dies
dieser	diesel
dieses	diesel
dieta	diet
dietas	diets
dietry	dietary
diety	dirty
dif	if
diferent	different
diferente	different
diferentes	differences
difestion	digestion
diff	riff
diffcult	difficult
diffculty	difficulty
differe	differ
differenza	different
differnt	different
difficiles	difficile
difficilty	difficulty
diffictlult	difficult
difficuelties	difficulties
difficulities	difficulties
difficultes	difficulties
difficultys	difficulty
difficuly	difficult
diffucult	difficult
diffuso	diffuse
dificil	deficit
dificult	difficult
dificulty	difficulty
diga	dig
digan	dian
diganosis	diagnosis
digestifs	digestif
digestivo	digestive
digetsive	digestive
diggestive	digestive
digiero	digger
dignosis	diagnosis
digo	dig
digt	dig
diharrea	diarrhea
diharreha	diarrhea
diifcult	difficult
diiference	difference
dijo	dino
dilations	dilation
dilerim	pilgrim
dilersen	diverse
diminu	dining
dimished	finished
din't	don't
dinasour	dinosaur
dinenr	dinner
dingen	dinged
dinger's	dinner's
dingetje	dinette
dinosaure	dinosaur
dinosour	dinosaur
diorrhoea	diarrhoea
dirai	dirac
directlly	directly
direkt	direct
diriger	driver
disabily	disable
disais	dishes
disapear	disappear
disapnea	disappear
disapnia	hispania
disapointed	disappointed
disapointment	disappointment
disappered	disappeared
disapppointed	disappointed
discart	discard
discernable	discernible
discomort	discomfort
disconfort	discomfort
discourging	discouraging
discribed	described
discription	description
discuter	disputer
disfuctional	dysfunctional
disfunction	dysfunction
disfunctional	dysfunctional
disguse	disguise
dishcharged	discharged
dishearted	dishearten
dishoom	dishonor
disipates	dissipates
dismisiveness	dismissiveness
dismissable	dismissible
dismobility	disability
dismorphia	dimorphic
disorderes	disorders
disparu	dispart
disphagia	dysphagia
dispite	despite
dispo	disco
disqualifed	disqualified
dissapate	dissipate
dissapear	disappear
dissapeared	disappeared
dissapears	disappears
dissapointed	disappointed
dissapointing	disappointing
dissappeared	disappeared
dissappointet	disappointed
disse	diss
dissmis	dismiss
dissmising	dismissing
distenstion	distension
distents	dissents
distruction	destruction
distruption	disruption
distrurbing	disturbing
disturbi	disturb
distusting	disgusting
dito	dit
diverticule	diverticula
diverticuli	diverticula
divey	dive
divulgar	vulgar
diy	did
diying	dying
diz	did
dizaines	dizziness
dizer	diner
dizzyness	dizziness
dj	do
djdnt	didn't
dk	do
dl	do
dlc	doc
dlr	dir
dm'd	did
dm'ed	died
dm's	da's
dmd	did
dmed	died
dmg	dog
dming	doing
dms	dos
dmv	dm
dna	na
dnd	and
dnf	and
dno	do
dnrs	does
dnt	dot
do'nt	don't
doagnosed	diagnosed
dobiti	debit
doch	dock
docor	door
docot	dicot
docotrs	doctors
docter	doctor
docteur	doctor
docteurs	doctors
doctify	notify
doctior	doctor
doctora	doctor
doctore	doctor
doctores	doctors
documentaci	documentary
documentating	documentation
dod	do
doen	down
doen't	don't
doenst	don't
does't	doesn't
doesbt	doesn't
doesen	does
doesn	does
doesnst	doesn't
doesnt	doesn't
doest	does
doet	does
dogg	dog
dogtor	doctor
doi	do
doin	down
dois	does
doivent	driven
dokie	okie
dokter	doter
dokters	doters
doktor	doctor
doktoru	doctor
dokumente	documents
dol	do
doli	doll
dolla	dollar
dolorida	florida
dolorosa	doloroso
dolorosas	dolorous
domanda	demand
domande	demand
doms	does
donc	done
donde	done
doner	done
donet	don't
donnera	donner
donno	dunno
donntry	country
dont	don't
donyou	donor
doo	do
dood	good
doodoo	voodoo
doombar	toolbar
doooo	door
doooone	doggone
doordash	doodah
doorgaat	doormat
doorzet	doormat
doozies	doozie
dopiero	dopier
dopo	dope
doppelganger	doppelgänger
dormir	dormer
dormmate	roommate
dorsi	doris
doruk	dork
doscovered	discovered
doseages	dosages
dosen't	doesn't
dosent	docent
doser	loser
dosers	losers
dosis	doses
dosnt	dost
dott	doth
dottera	dotter
dottor	doctor
dottore	doctor
doubke	double
doubtedly	doubted
douchey	douche
douleur	douceur
douleurs	douceur
doute	route
doutez	route
dowiem	dowie
downloader	downloaded
downpayment	nonpayment
downton	downtown
downvote	downcome
downvoting	nonvoting
downwardd	downward
dows	down
dox	do
dpr	dir
dr's	da's
dramammine	dramamine
dramatising	dramatizing
drammamine	dramamine
dran	ran
drau	draw
draught	drought
drb	dry
dre	are
dreamt	dream
drie	die
driking	driving
driljard	dillard
dringking	drinking
drinked	drinker
drinken	drunken
drinki'm	drinking
drinkin	drinking
drinkmate	drinkwater
drinkt	drink
drinky	drink
drinling	drinking
driveable	drivable
dro	do
drogas	drugs
droite	droit
drom	from
drpepper	pepper
drs	dry
druck	drunk
drunking	drinking
drunkness	drunkenness
dryoo	drop
ds	is
dsm	dam
dt	it
dtay	stay
dtl	del
dtla	deal
dudeeee	dudeen
dudnt	dunt
duele	duel
dueo	due
duimen	driven
dum	due
dumbass	dumbest
dummen	summer
dummest	dumbest
dummis	dummies
dumont	dupont
dunkin's	dunking
dunni	dunno
duno	dung
duodemum	duodenum
duplicado	duplicate
dupra	supra
duquant	durant
duquer	dumber
durch	dutch
durchf	dutch
dure	sure
duren	duran
durf	surf
durrr	durra
dus	us
dutchies	duchies
duur	dour
duurde	dude
duurt	hurt
dva	va
dvd	did
dvt	dot
dw	do
dwyer	dryer
dx	do
dx'd	did
dyfunction	dysfunction
dyrt	dirt
dys	days
dysbiosis	symbiosis
dysfonction	dysfunction
dysfunktion	dysfunction
dysfuntion	dysfunction
dyshpagia	dysphagia
dysphagie	dysphagia
dyspnoea	dyspnea
dysport	disport
dyspraxia	dyscrasia
dysprexia	dyslexia
dysregulation	deregulation
dyssenergia	dyssynergia
dyssnergia	dyssynergia
dyssynergic	dyssynergia
dystonia	dystopia
dystonias	dystopias
dystonic	systolic
dystort	distort
dysunction	dysfunction
dyyying	dying
dzmi	damn
eaing	eating
eaither	either
ealiest	easiest
eam	am
earliee	earlier
earnt	earn
earplanes	warplanes
easyy	easy
eated	hated
eb	be
eberyone	everyone
ebook	book
ebs	es
eby	by
eccomi	encomia
ecember	december
ecgs	eggs
echoey	echoes
echter	echoer
echtere	echoer
ecig	cig
ecigarette	cigarette
ecoli	cold
econsult	consult
ecp	eco
ecpd	rcpd
ect	eat
ectbot	cabot
eczno	echo
edc	ed
edg	edge
edgeorge	george
edgware	edgar
edm	ed
eds	ends
edting	eating
edu	du
educatedly	educated
ee	we
eecommend	recommend
eed	need
eee	see
eeearly	early
eeeasily	easily
eeee	see
eeeee	geese
eeeeee	peewee
eeeeh	teeth
eeeek	week
eeeever	cheever
eeek	week
eeesh	eyes
eeew	see
een	been
eens	tens
eep	keep
eerder	herder
eeriely	eerily
eerst	erst
eerste	verse
eesh	mesh
eet	get
eeuu	menu
eew	new
efecto	effect
effecs	effect
effecst	effect
effecten	effected
effectieve	effective
effectivess	effective
effectiviness	effectiveness
effectu	effect
effekt	effect
effekten	effected
effektivt	effective
effet	effect
effets	effects
effexor	flexor
efficace	efficacy
efficency	efficiency
efficiant	efficient
effot	effort
effraying	fraying
efter	after
egd	end
egds	ends
egen	even
eggy	eggs
egh	egg
egj	egg
egjoo	enjoy
ehat	that
eher	her
ehh	eh
ehhh	each
ehhhh	ephah
ehler	euler
ehler's	ehlers
ehm	eh
eho	who
ei	i
ei'm	i'm
eig	big
eigen	even
eigenen	eugene
eilish	finish
eilluminati	illuminati
ein	in
einde	eide
eine	fine
einem	eminem
einen	linen
eines	lines
einfach	enface
eingang	singing
einige	finite
einigen	bingen
einmal	final
eir	air
eirther	either
eisen	risen
eitehr	either
eith	with
ej	e
ekg	egg
ekgs	eggs
ekilde	exile
ekstra	extra
ekti	eat
ela	la
elae	else
elastase	diastase
elavated	elevated
elavil	evil
elctromyograph	electromyography
elderley	elderly
ele	else
electrolit	electronic
electromyographic	electromyographies
electromyograpy	electromyography
elementay	elementary
eles	else
eleviate	elevate
elhers	elders
elie	else
elige	elite
eliminaci	eliminate
eliminacion	elimination
eliminar	eliminate
eliminas	eliminate
elin	lin
eliviates	eliminates
elke	else
ellbows	elbows
elle	else
ellement	element
eller	elder
ellers	elders
elles	elves
ellicit	illicit
ello	hello
ellos	ellis
elon	melon
else's	ease's
elses	else
emaing	making
emarassing	embarrassing
emat	eat
emataphobia	emetephobia
ematophobia	emetephobia
ematophobic	emetophobic
embarassed	embarrassed
embarassing	embarrassing
embarassingly	embarrassingly
embarassment	embarrassment
embaressed	embarrassed
embaressing	embarrassing
embarrased	embarrassed
embarrasing	embarrassing
embarrasment	embarrassment
embarrassement	embarrassment
embarresing	embarrassing
embarressing	embarrassing
embasy	embassy
emberrassing	embarrassing
embrassed	embarrassed
emcs	ems
eme	me
emeitophobia	emetephobia
emeophobia	ergophobia
emeotphobia	emetephobia
emeotphobic	emetophobic
emergencys	emergency
emerophobia	aerophobia
emertophobic	emetophobic
emet	meet
emetaohobia	emetephobia
emetaphobe	emetephobes
emetaphobes	emetephobes
emetaphobia	emetephobia
emetaphobic	emetophobic
emetaphobics	emetophobic
emetepbobia	emetephobia
emetephilia	emetephobia
emetephobe	emetephobes
emetephobic	emetephobia
emethophobia	emetephobia
emetiphobe	emetephobes
emetiphobia	emetephobia
emetiphobic	emetophobic
emeto	meet
emetofobic	emetophobic
emetohobes	emetephobes
emetohobia	emetephobia
emetopbobia	emetephobia
emetophbia	emetephobia
emetophbic	emetophobic
emetophibia	emetephobia
emetophic	metopic
emetophiobia	emetephobia
emetophob	emetophobic
emetophoba	emetephobia
emetophobe	emetephobes
emetophobes	emetephobes
emetophobia	emetephobia
emetophobiac	emetophobic
emetophobics	emetophobic
emetophobie	emetophobic
emetophobja	emetephobia
emetophoebic	emetophobic
emetophones	emetephobes
emetophopbia	emetephobia
emetophopia	emetephobia
emetophpbia	emetephobia
emetopjobic	emetophobic
emetopobia	emetephobia
emetphobia	emetephobia
emetrol	petrol
emetrophobia	emetephobia
emets	meets
emg	egg
emgality	equality
emited	edited
emitephobia	emetephobia
emitiphobes	emetephobes
emitiphobia	emetephobia
emito	emit
emitophibic	emetophobic
emitophobes	emetephobes
emitophobia	emetephobia
emitophobic	emetophobic
emittophobic	emetophobic
emla	emma
emmenating	emanating
emmetophobic	emetophobic
emo	ego
emoji	mojo
emood	mood
emorys	emory
emosh	mosh
emotophboic	emetophobic
emotophobia	photophobia
emotophobic	emetophobic
empathise	empathize
empec	expect
empez	empty
empezar	emperor
emphasise	emphasis
emphasised	emphasized
emphasises	emphasizes
emphatize	emphasize
empt	empty
emptive	emotive
emtophobia	ergophobia
emtpy	empty
emts	eats
encanto	enchant
encontr	encounter
encourafe	encourage
encouragment	encouragement
encourangement	encouragement
enda	end
endast	ends
ende	end
endeavour	endeavor
endeavoured	endeavored
endeavours	endeavors
endescopy	endoscopy
endlesss	endless
endnu	end
endo	end
endoscapies	endoscopes
endoscoped	endoscope
endoscopie	endoscopic
endoscopies	endoscopes
endoscopys	endoscopy
endosocopy	endoscopy
endosocpy	endoscopy
endroit	android
endroits	androids
endsocopy	endoscopy
endte	enate
ene	one
energency	emergency
energias	energies
energised	energized
enero	nero
eneste	nest
enetephobe	emetephobes
enetephobia	emetephobia
enetrologist	neurologist
enfin	elfin
enflame	inflame
enflamed	inflamed
engagemet	engagement
engeland	england
engelsk	engels
englander	england
englisch	english
enige	nice
enit	unit
enkele	ankle
enkelt	knelt
enlight	penlight
enligt	enlist
enn	end
eno	no
enoki	enki
enoki's	enki's
enorm	norm
enorma	norma
enory	entry
enought	enough
enserio	enteric
ensuite	ensure
ent's	rent's
entend	intend
entender	engender
entendu	intend
enterado	entered
enteraste	esterase
enterologist	entomologist
enterologists	entomologists
enthusiam	enthusiasm
entiende	sentience
entitely	entirely
entng	eating
entonces	sentences
entorologists	entomologists
entra	extra
entrar	entrap
entre	entire
entree	entrée
envie	envied
enviroment	environment
enviromental	environmental
environement	environment
eny	any
enyzme	enzyme
enzimatico	enzymatic
enzsymes	enzymes
eo	to
eob	job
eoe	eye
eosinophilic	eosinophil
eosophagal	esophageal
eosophagas	esophagus
eosophageal	esophageal
eosophagus	esophagus
eosphagal	esophageal
eould	would
epazote	azote
epc	epic
epi	epic
epicentre	epicenter
epigastric	digastric
epiglotis	epiglottis
epiglottic	epiglottis
epiglottitis	epiglottis
epley	play
epost	post
eposter	poster
eppiglottis	epiglottis
epr	per
epv	ep
epworth	worth
epxlicitly	explicitly
equalise	equalize
equalising	equalizing
equipe	equip
erachter	richter
eravamo	bravado
erbij	erbil
erdem	order
eres	eyes
erfolg	enfold
ergens	urgent
erger	eager
ergh	ergo
erkl	erk
erlangen	erlanger
erm	arm
erp	era
erps	reps
erpy	espy
erreurs	errors
erro	error
errr	error
errrm	error
errrr	error
ers	ears
erste	este
erstmal	eastman
eructa	eruct
eructar	erector
eructile	erectile
eructo	eruct
eructos	eructs
ervan	evan
ervaring	roaring
erythromicin	erythromycin
erz	era
es's	e's
esa	sea
esaphogus	esophagus
escondidos	escondido
escpecially	especially
escribelo	escribe
escribo	escribe
escrito	esprit
escuchar	eschar
ese	see
esegue	segue
esepecially	especially
esfinter	sinter
eshlau	ashlar
esl	es
eso	so
esofagus	esophagus
esohpagus	esophagus
esom	som
esomeprazole	omeprazole
esoohagael	esophageal
esopgaheal	esophageal
esopghageal	esophageal
esopghagus	esophagus
esopgogus	esophagus
esoph	elope
esophagael	esophageal
esophagal	esophageal
esophagea	esophageal
esophagel	esophageal
esophageous	esophagus
esophageus	esophagus
esophagial	esophageal
esophagistis	esophagitis
esophagous	esophagus
esophagram	esophageal
esophagsus	esophagus
esophagul	esophagus
esopheal	esophageal
esophegal	esophageal
esophegas	esophagus
esophegeus	esophagus
esophegial	esophageal
esophegus	esophagus
esophgeal	esophageal
esophgitis	esophagitis
esophogas	esophagus
esophogeak	esophageal
esophogeal	esophageal
esophogial	esophageal
esophogitis	esophagitis
esophogitus	esophagitis
esophogus	esophagus
esophougus	esophagus
esos	pesos
esp	es
espa	spa
espace	space
espacially	especially
espanol	ethanol
especialist	specialist
especialista	specialist
especialistas	specialists
especialy	especially
especifically	specifically
esperience	experience
espero	expert
espirit	spirit
espohageal	esophageal
espohagus	esophagus
espoir	spoil
espophagus	esophagus
esque	rescue
essa	essay
essaye	essay
essentialy	essential
essere	essene
esses	asses
essophagus	esophagus
esspresso	espresso
est	best
esta	eta
estaba	estate
estado	estate
estados	estates
estar	star
estas	estes
estatic	static
esterna	sterna
estevan	esteban
estilo	still
estimulantes	stimulates
esting	eating
esto	este
estos	estes
estou	estop
estoy	estop
estr	este
estreso	stress
estricta	strict
estuation	situation
estudio	studio
estudios	studios
estupido	stupid
estuve	estate
etc	et
etd	end
ete	eye
eten	even
ethmoids	ethmoid
etlichen	lichen
etlicher	etcher
etsy	easy
ett	eat
etter	better
etterp	better
etwa	eta
etwas	twas
eua	era
eucerin	euchring
euch	much
euh	uh
eurem	eure
eurovision	provision
eurp	euro
eurps	euros
euschian	eustachian
eusophageal	esophageal
eusophagus	esophagus
eustachean	eustachian
eustacian	eustachian
euston	huston
euuh	much
euuu	guru
eux	ex
evacuator	evaluator
eval	evil
evangelise	evangelist
evenegot	evenest
eventaully	eventually
eventuell	eventually
eventuelt	eventual
eventuily	eventually
everbody	everybody
evereyone	everyone
everhthing	everything
everly	every
everthing	everything
evertually	eventually
everuone	everyone
everybday	everyday
everybite	overbite
everyhting	everything
everynight	overnight
everyones	everyone
everyrhing	everything
everythings	everything
everytime	overtime
everyting	everything
eveuthing	everything
evexn	even
eveyrwhere	everywhere
evidentally	evidently
evious	envious
evning	evening
evodius	exodus
evry	very
evt	eat
ew	we
eww	ewe
ewww	wow
exacerbator	exacerbated
exaclty	exactly
exacrly	exactly
exactement	excitement
exacttt	exactly
exagerrated	exaggerated
exakt	exact
exames	exams
examinated	examined
examity	examine
exasberpated	exasperated
exaserbated	exacerbated
exavtly	exactly
exaxct	exact
exaxt	exact
excacerbates	exacerbates
excaping	escaping
excaserbated	exacerbated
excat	exact
excatly	exactly
excavatum	excavated
excema	except
excendrine	excedrin
excercices	exercises
excercies	exercise
excercise	exercise
excercises	exercises
excercising	exercising
excerise	exercise
excerises	exercises
excersies	excesses
excersion	excursion
excersise	exercise
excersises	exercises
excersize	excessive
excesive	excessive
excesivelly	excessively
exceso	excess
excessivley	excessively
excessivness	excessiveness
excessivos	excessive
excesss	excess
excitment	excitement
excl	excel
excluye	exclude
excpected	expected
excrutiating	excruciating
execrises	exercises
execrising	exercising
exedrin	excedrin
exentsion	extension
exept	except
exercice	exercise
exercices	exercises
exercisen	exercise
exercizes	exercises
exersise	exercise
exersises	exercises
exersize	exercise
exetremely	extremely
exexute	execute
exhasperated	exasperated
exhel	expel
exict	exact
exisitant	existent
exisiting	existing
existance	existence
existe	exist
existen	existed
existings	existing
existst	exists
exp	ex
expanation	explanation
expecially	especially
expectedly	expected
expell	expel
expence	expense
expensiv	expensive
expereiences	experiences
expereince	experience
expereinced	experienced
experiance	experience
expericed	experienced
experiencee	experience
experiencers	experiences
experiencias	experiencing
experimenation	experimentation
experince	experience
experinced	experienced
expertd	expert
expertises	expertise
experto	expert
expetience	experience
expexted	expected
expidited	expedited
expierence	experience
expierenced	experienced
expirement	experiment
expirence	experience
expirience	experience
explaination	explanation
explainations	explanations
explenation	explanation
explic	explain
exploradora	exploratory
exploratoria	exploratory
exponencial	exponential
exponentialy	exponentially
expresso	express
expriences	experiences
expulsar	pulsar
expulse	excuse
expulsed	exposed
expulso	expulsion
extea	extra
externe	eterne
extirpar	extirpate
extracurriculars	extracurricular
extrapolo	extrabold
extreamly	extremely
extrem	extreme
extremly	extremely
extremo	extreme
extrinsicly	extrinsic
extubation	exhumation
exurcise	exercise
exurcises	exercises
exuse	excuse
ey	my
eyeroll	eyeball
eyerolling	eyeballing
eyesbows	eyebrows
eze	eye
ezomeprazole	omeprazole
f'd	i'd
faaaar	bazaar
fabolous	fabulous
faccia	fascia
facetime	facetiae
facetiming	faceting
facewash	backwash
facialy	facial
facil	fail
facinated	fascinated
facs	face
facsent	accent
factly	fatly
facto	fact
facultad	faculty
faffy	taffy
fago	ago
fahad	fahd
faible	fable
failburps	failures
faily	family
faire	fire
faired	fired
fairlife	airline
fais	fair
faisais	faisal
faisait	faisal
faisant	faint
fait	wait
faite	faith
faites	fates
fakeeh	fake
fakest	fakes
faktisk	fattish
fakultn	fault
falar	alar
falde	false
falder	folder
fallet	fallen
fallo	fall
fam	am
fama	mama
familia	familiar
familiares	familiars
familiarise	familiarize
familiarised	familiarized
familiarising	familiarizing
familie	families
famille	camille
famitodine	famotidine
famodadine	famotidine
famoditine	famotidine
famotadine	famotidine
famotodine	famotidine
fannin	fanning
fanno	fanny
fant	want
fanta	santa
fantasticly	fantastic
fantastiskt	fantasist
fantin	fanti
fantstic	fantastic
fap	far
faqs	fans
farla	carla
farlo	carlo
farmi	farm
farrer	farmer
farrrr	farmer
farrt	fart
farrting	farting
fartbag	farting
fartbook	facebook
farter	faster
farters	farmers
fartichokes	artichokes
fartiest	farthest
fartin	martin
fartiness	artiness
fartsy	farts
farty	party
fas	was
fascial	facial
fasciitis	fascists
fase	face
fashioneds	fashioned
fasse	false
fastfood	eastwood
fastly	vastly
fastor	faster
fasttrack	fastback
fathome	fathom
fatique	fatigue
fattar	fatter
fatto	fatty
fauquier	faquir
faut	fact
fav	far
favore	favor
favour	favor
favoured	favored
favouring	favoring
favourite	favorite
favourites	favorites
favours	favors
favs	fans
faz	far
fazer	faze
fb	fa
fbi	bi
fckin	fucking
fcking	fucking
fckn	can
fd	fed
fda	fa
fealing	feeling
fearmongering	warmongering
feber	fever
februar	february
febuary	february
feburary	february
fecking	fucking
fedt	felt
feedbacks	feedback
feeel	feel
feeeling	feeling
feeing	feeling
feelign	feeling
feelin	feeling
feelsgood	feelgood
feelt	feel
feesback	feedback
fef	few
feil	feel
feilds	fields
feimster	fester
feinstein	einstein
feira	feria
feit	felt
fel	feel
feleing	feeling
felicidad	felicia
felicidades	felicitates
felicitarte	felicitate
felicito	felicity
feliz	felix
fello	fell
fely	felt
femlae	female
fentanyl	fontanel
fenzy	frenzy
fep	few
ferait	fruit
feramax	ceramal
feraz	feral
ferb	herb
ferez	perez
fermentables	fermentable
fernandes	fernandez
fernet	ferret
ferous	ferrous
fesidious	insidious
fetishing	fishing
fett	felt
fettish	fetish
fettuccini	fettuccine
ff	of
ffade	fade
ffat	fat
ffffu	faff
ffound	found
ffp	fop
ffs	ifs
fhe	the
fiable	liable
fianc	franc
fiance	finance
fiancee	fiancée
fiberoptic	fibrotic
fibre	fire
fibres	fires
fibro	fire
fibroids	fibroid
fibroscopy	microscopy
ficiente	licente
ficier	dicier
fick	fuck
fidati	fixate
fidnt	didn't
fijn	fin
fijne	fine
fik	fix
fikk	fink
fil	fix
filha	fila
fille	fill
filmsets	fillets
filtraciones	filtration's
finalement	inclement
finalised	finalized
finalllly	finally
finallyy	finally
finalnie	finance
financi	finance
financials	financial
finde	find
findes	finds
findthe	finite
finically	finally
finit	finite
finnaly	finally
finnicky	finicky
fippla	fipple
firce	fire
firends	friends
firlmy	firmly
firts	first
fisico	disco
fisrt	first
fitbit	titbit
fived	five
fiving	living
fixa	fix
fixe	five
fiy	fix
fiz	fix
fizemos	gizmos
fizzers	fizzes
fizzies	fizzles
fizziness	dizziness
fizzley	fizzle
fizzying	dizzying
fizzyness	dizziness
fk	ok
fkd	fed
fkin	skin
fking	king
fkkng	king
fkn	fun
flacid	flaccid
flactulance	flatulence
flaired	flared
flappy	floppy
flatbread	flatbed
flatlence	flatulence
flatluent	flatulent
flattulence	flatulence
flatualence	flatulence
flatuence	flatulence
flatulalence	flatulence
flatulance	flatulence
flatulances	flatulence
flatulate	flatmate
flatulences	flatulence
flatulencr	flatulence
flatulenece	flatulence
flatuna	flaunt
flautance	elastance
flaves	slaves
flavour	flavor
flavoured	flavored
flavouring	flavoring
flavours	flavors
flavoursome	flavorsome
flegm	fleam
fler	flew
flere	flee
flesta	fiesta
flexi	flex
flink	link
flipant	flippant
flippin	flipping
flipsides	lipides
florian	florin
florinef	florine
flosser	flossed
flossers	flosses
flowpaths	footpaths
flowy	flow
floxed	flowed
fluctuance	fluctuate
fluey	flue
fluish	flush
fluoro	fluor
fluroscopy	fluoroscopy
flus	plus
flutuates	fluctuates
flx	fix
fmaj	maj
fmc	fm
fml	fl
fmla	fila
fnp	fop
fo	to
focalin	focal
foco	loco
foda	soda
fodmap	formal
fodmaps	formats
fofa	sofa
foi	for
fois	foil
fokus	focus
fol	for
folic	frolic
folllowed	followed
followups	followup
followwed	followed
folx	folk
fomo	homo
fonction	function
fonctionn	function
foo	for
foodpipe	foodie
foodway	footway
foody	food
fooor	floor
forblev	forbes
forc	for
forcefed	forced
forcep	force
foregik	foreign
foretaget	foretaste
forf	for
forhorn	forlorn
forl	for
forma	form
formar	former
formating	formatting
formme	forme
formum	forum
fornemt	forget
foro	for
foros	forms
forreal	formal
fors	for
forse	force
forst	first
forsure	fortune
forteller	foreteller
fortement	foremen
forths	forth
fortisip	fortis
fortunatly	fortunately
forumet	forget
forummet	grummet
forzado	forzando
fot	for
fout	out
foutje	route
foward	forward
fown	down
foxnews	foxes
fp	up
fpr	for
frage	frame
fragen	frauen
fram	from
francks	francs
franks's	frank's
frappe	frapped
frcs	arcs
freakin	freaking
freeaaks	freaks
freeeee	freebee
freeezing	freezing
freezies	freezes
freggin	regain
frem	from
frente	front
fresia	freesia
frick	trick
fricken	chicken
frickin	tricking
fricking	tricking
friggen	frigged
friggin	frigging
frim	from
frio	trio
frist	first
fritas	fits
frkm	from
frm	from
frogger	flogger
froggers	floggers
froggie	doggie
frogging	frigging
froggish	frogfish
froggys	froggy
froglike	broglie
froma	from
fromy	from
fron	from
frontl	front
frontside	frontline
frother	brother
frreal	real
frrr	for
fructan	fractal
fructans	fractals
fructase	fructose
fruitape	fruitage
frustating	frustrating
frustraci	frustrate
frustrante	frustrate
fruta	frusta
frutti	fruit
fs	is
fsa	fa
fsu	flu
ft	it
fte	ate
ftm	fm
ftp	fop
ftw	few
fu	fun
fuckery	fucker
fuckin	fucking
fuckity	fucking
fuckn	fuck
fuckton	futon
fucky	fuck
fudgy	fudge
fue	fun
fuertes	fuentes
fuerza	feria
fui	fun
fuit	fit
fuk	fuck
fuld	full
fullcorn	bullhorn
fulle	full
fulllll	fulfill
fumerate	numerate
funcion	function
funciona	function
funcional	functional
funcionar	functional
funderat	funeral
funders	founders
fundet	funded
fungals	fungal
fungere	finger
fungeret	fingered
funkade	unmade
funkar	fucker
funnet	funnel
funnnn	funny
funy	fun
fuori	for
furball	fireball
furoate	furcate
furtherly	further
fustrating	frustrating
fut	but
futher	father
futhermore	furthermore
fw	few
fwabble	wabble
fx	fix
fyp	fop
fz	fa
g'day	day
gaan	gain
gaat	goat
gaba	gala
gabbage	garbage
gabe	gave
gaelyn	gallon
gaf	gas
gaggyness	gayness
gah	gas
gahh	gash
gahhh	gash
gai	gas
gails	nails
galactans	galatians
galactase	galactose
galactica	galactic
galati	galata
galatis	galatia
gald	glad
galement	basement
galitz	glitz
gallatis	gallants
gallen	fallen
galliano	gallant
gamiseus	gamine's
gammel	gammer
gandalf	randall
gange	gang
gangst	gangs
ganj	gang
ganz	gang
ganze	gaze
garde	garden
garganta	gargantua
garggling	gargling
gargl	gargle
garglers	gargles
gargley	gargle
gargly	gargle
garlicy	garlic
garmin	gamin
garnicht	garnish
garps	gasps
gascom	gascon
gasid	gadid
gasier	easier
gasiness	easiness
gasing	gasping
gasless	assess
gaslighted	slighted
gaslighter	gaslight
gaslighting	alighting
gaslighty	gaslight
gasonex	gamone
gaspy	gasps
gass	ass
gastar	gaspar
gastastic	fantastic
gaste	waste
gastic	gastric
gasto	gusto
gastoscopys	gastroscopy
gastrectomies	mastectomies
gastrex	gastric
gastriris	gastritis
gastris	gastric
gastrites	gastritis
gastrocolic	gastronomic
gastrocopy	gastroscopy
gastroenerologists	gastroenterologist
gastroenterologis	gastroenterologist
gastroenterologist's	gastroenterologist
gastroenterologists	gastroenterologist
gastroenterologo	gastroenterology
gastroentorologist	gastroenterologist
gastroentorologists	gastroenterologist
gastroentrologist	gastroenterologist
gastroentrrologist	gastroenterologist
gastroesophgeal	gastroesophageal
gastrogenerologist	gastroenterologist
gastrointerologist	gastroenterologist
gastrointestinales	gastrointestinal
gastrointestinally	gastrointestinal
gastrointestinals	gastrointestinal
gastros	gastro
gastroscopic	gastroscope
gastroscopie	gastroscope
gastroscopies	gastroscope
gastroskopi	gastroscope
gasy	easy
gatekeep	gatekeeper
gatekeeping	safekeeping
gatif	gate
gatsro	gastro
gatwick	patrick
gaurentee	guarantee
gauteng	gluten
gauzes	gauze
gav	gave
gavaskon	gaviscon
gaves	gave
gavicscon	gaviscon
gaviscom	gaviscon
gaviscons	gaviscon
gavisgon	gaviscon
gavisvon	gaviscon
gawker's	hawker's
gawrsh	harsh
gaz	gas
gazeuse	gazelle
gazeuses	gazelles
gazy	gay
gb	go
gbp	gap
gbs	gas
gc	go
gcse	give
gcses	gases
gda	ga
gde	de
gebeld	rebel
geben	eben
gebeurd	geber
gebeurt	ebert
gedaan	german
gedekt	geek
gedoe	geode
geduld	gerald
geeetings	greetings
geeked	peeked
geeking	seeking
geen	been
geesh	geese
gef	get
gegaan	began
gegen	been
geh	get
gehad	jehad
gehe	gene
gehen	when
geholpen	beholden
geht	get
gehts	gets
gej	get
gek	get
gekomen	genome
gekund	gerund
gelaten	gelatin
gelato	relate
gelbard	gerard
gelebt	select
geleden	golden
gelesen	eleven
gelijk	gelid
geloof	gloom
gelse	else
geluid	gelid
geluk	glue
gelukt	glut
gemaild	email
gemerkt	demerit
genaue	genius
geneid	aeneid
generale	general
generalisation	generalization
generalised	generalized
generan	general
generar	general
generarme	generate
genere	genre
genereal	general
genesight	eyesight
genious	genius
geniunely	genuinely
gennem	genned
gennemf	genned
genomen	genome
genommen	genome
gente	gentle
gentiment	sentiment
genuinley	genuinely
genuinly	genuinely
genuously	tenuously
georg	george
gepland	gland
gerade	grade
geraldo	gerald
geredet	greet
gereist	persist
germaphobe	germanophobe
germophobe	germanophobe
gern	germ
gerne	gene
gernes	genes
gerping	getting
gerps	germs
gerust	trust
gesagt	gestalt
gescand	descend
gesteld	tested
gestellt	estella
gestern	western
gesto	pesto
gestoken	betoken
getcha	betcha
getiing	getting
geting	getting
getr	get
getraind	retrain
gettin	getting
getttt	getter
getv	get
geval	reval
gevallen	befallen
geven	even
gevoel	level
geweest	newest
gewisse	neisse
gewoon	goon
geworden	reworded
gezet	genet
gezien	genie
gf	of
gf's	if's
gger	ger
ggf	of
gging	going
ghd	god
ghibli	chili
ghis	this
ghrelin	gremlin
ghs	gas
giannis	giants
giardia	guardian
gibt	gift
gica	gina
gicas	girls
gick	pick
gico	rico
gidder	bidder
gif	if
gifs	gift
gigante	gigantes
gigaton	megaton
gikk	gink
gilati	gelatin
giliberto	gilberto
gillet	fillet
gillett	gillette
gillick	killick
gime	give
gimes	times
gine	give
ging	going
gingee	ginger
gingen	ginger
gingerale	gingerly
giorno	porno
gipping	ripping
girfriend	girlfriend
girggles	giggles
girthy	girth
gis	is
gister	sister
gita	git
giudice	lidice
giv	give
gj	go
gjerne	gene
gjess	guess
gjet	get
gjorde	george
gjort	got
gkv	guv
gl	go
glas	glad
glasto	last
glat	glad
glaub	glad
glaube	glauce
gld	old
gleeks	geeks
gleiche	aleichem
gler	glee
glich	glitch
globo	globe
gloop	loop
glp	gap
gluconeogenisis	gluconeogenesis
glug	plug
glugging	plugging
glugs	slugs
glups	gulps
glurgling	gurgling
glurp	slurp
glurps	slurps
glute	glue
glutened	gluten
glutes	gluten
glutition	glutton
glycinate	glaciate
gmail	mail
gmaps	maps
gmb	gob
gmc	my
gmo	go
gna	na
gnede	glede
goated	coated
goddamnit	goddammit
gode	gone
godinne	iodine
godk	god
godofnsa	godowns
godt	got
goed	good
goede	geode
gogo	logo
goi	got
goign	going
goijng	going
goin	going
gola	gold
golli	golly
gon	on
gona	gonna
gones	goes
gonfl	gonna
goni	gone
gonstans	constant
gooble	google
gooch	pooch
gooden	golden
goodman's	goldman's
goodrx	good
googla	google
googled	google
googles	google
googling	goggling
gooo	good
goood	good
goooo	good
gooood	good
gooooo	voodoo
goooood	godhood
goosebump	goosebumps
goosey	goose
gor	for
gora	fora
gord	good
gorgling	gurgling
gorgoling	gurgling
gornals	gorals
gos	got
goshhh	gosh
goss	goes
gota	got
gotchu	gotcha
goto	got
gotowa	gotta
gots	got
gotto	gotta
gottta	gotta
goverment	government
govs	goes
gps	gas
gpt	get
gra	grab
graaff	graft
graag	great
grabbiness	crabbiness
gracias	gracious
gradiant	radiant
gradiants	gradients
grammer	grammar
grandaughter	granddaughter
grande	grand
granndaughter	granddaughter
granpda	grandpa
grap	grab
grassiness	brassiness
gratefull	grateful
grats	grass
grattis	gratis
gravis	graves
gravitum	gravity
gravol	gravel
grazie	graze
grd	god
greatful	grateful
gred	red
greenlit	greenlet
greensmoke	greenstone
greentea	greeted
greenville	grenville
greesy	greedy
greggs	greg's
grejen	green
gren	green
grenouille	grenville
grensene	greene
grigio	origin
grinded	grinder
grishma	geisha
grlfriend	girlfriend
gro	go
groak	groan
groanies	groans
groany	groans
groban's	groan's
groeten	gotten
groging	growing
grom	from
gromace	grimace
groover	groove
grose	rose
grosse	gross
grossssss	grossness
grotere	grocery
groupe	group
growlly	growly
grr	err
grrr	girl
grrrr	error
grt	get
grugles	gurgles
grund	ground
gruner	grunter
grunty	grunts
grupo	group
grupos	grunts
gruppe	grippe
gruppen	gripped
gstt	get
gt	it
gta	ga
gtfo	to
gtn	gun
gtube	tube
gu	go
gua	guy
guac	guan
guarana	guarani
guardium	guardian
guasha	geisha
gue	guy
guffs	cuffs
gugrles	gurgles
guias	glias
guidances	guidance
guilherme	guillermo
guiness	guineas
guinnea	guinea
gumble	humble
gummies	dummies
gung	gun
gunna	gonna
gurg	guru
gurgaon	surgeon
gurgeling	gurgling
gurgelling	gurgling
gurgeln	surgeon
gurgels	gurgles
gurgely	surely
gurggeling	gurgling
gurggle	gurgle
gurggled	gurgled
gurggles	gurgles
gurggling	gurgling
gurgledom	gurgled
gurgler	gurgles
gurglers	gurgles
gurgley	gurgles
gurglez	gurgles
gurglie	gurgle
gurglies	gurgles
gurgliness	ugliness
gurglingin	gurgling
gurglings	gurgling
gurglly	gully
gurgly	gurgle
gurgoe	gurgle
gurgs	gurus
guri	guru
gurl	girl
gurles	gurgles
gurlge	gurgle
gurlges	gurgles
gurlgle	gurgle
gurlgler	gurgles
gurlgles	gurgles
gurlgling	gurgling
gurling	curling
gurly	curly
gurp	guru
gurping	burping
gurple	purple
gurps	burps
gurrgles	gurgles
gustar	guitar
gute	cute
guten	gluten
guti	guts
gutsir	gutsier
guuurgle	gurgle
guves	gives
guyz	guys
gw	go
gwmedical	medical
gwt	get
gwu	wu
gwuh	guy
gyn	gun
gynae	gone
gynaecologist	gynecologist
gyno	gyro
gyns	guns
gyrgles	gurgles
haaa	hasa
haaaate	hamate
haagen	hagen
haah	hath
haahah	hannah
haban	habana
habanero	habanera
habaneros	habanera
habbit	habit
habe	have
haben	haven
haberlos	haber's
haberse	hearse
habing	having
habite	habit
habituel	habitual
habla	tabla
hablando	harland
hablante	ablate
hablantes	ablates
hablar	hangar
hablara	habana
hable	able
hablo	halo
habr	hair
habt	hat
hace	have
hacen	haven
hacer	hacker
hacerte	lacerate
hachi	each
haci	hack
hacia	dacia
haciendo	hacienda
hacklin	hacking
hacky	hack
hadbt	hadst
hadde	hade
hadden	hidden
hadern	hadean
hadn	had
hadnt	hadn't
hadve	have
hafe	have
hafta	haft
haga	hag
hagan	pagan
hagas	hags
hago	ago
haha	hah
hahaa	hah
hahaah	hannah
hahah	hamah
hahaha	yamaha
hahahah	halakah
hahahh	hamah
hahai	bahai
hahh	hath
hahha	hath
hahhah	hannah
hai	had
hailz	hail
haitus	hiatus
haivng	having
hali	half
halp	help
halsen	hansen
halstead	halted
hamborg	hamburg
hamburgu	hamburg
hamid	amid
hamnar	hammer
hampagne	champagne
hana	hand
hand't	hadn't
handedly	handed
handfull	handful
handig	handing
handikappad	handicapped
handwashing	handfasting
hane	have
hangin	hanging
hangry	angry
hangxiety	anxiety
hangy	hang
hanno	hanna
haooen	happen
haopy	happy
hapoens	happens
happaned	happened
happed	happen
happen's	happens
happend	happened
happenend	happened
happenening	happening
happenes	happened
happenfs	happens
happing	tapping
happned	happened
happyer	happier
har	her
hara	hard
harassments	harassment
harbouring	harboring
hardboiled	parboiled
hardgainer	hardliner
haribo	harbor
harta	hart
hartnick	heartsick
hasard	hazard
hashi	hash
hasn	has
hasnt	hasn't
hassan	asian
hasta	pasta
hatanp	hating
hateddd	hated
hatte	hate
haukeland	lakeland
hault	fault
haus	has
haut	hat
hav	have
havde	have
haveif	have
havent	haven't
havent's	haven's
havers	haters
havign	having
havn	have
havn't	haven't
havne't	haven't
havnf	have
havnt	haunt
havr	have
hawai'i	hawaii
hayley	haley
haz	had
hazzard	hazard
hbauch	hatch
hbf	hb
hbu	hub
hca	ha
hcl	hel
hcpcs	hopes
hd	he
hdhp	help
hdl	hel
hdp	hop
heaaaps	heaps
headachey	headache
headbang	headband
headcold	headword
headedness	headdress
headpain	headpin
headstart	headscarf
heae	here
heaf	hear
healty	health
hearable	bearable
hearburn	heartburn
heared	heard
heartburns	heartburn
heartedly	heatedly
heatburn	heartburn
heathcare	healthcare
heavying	heaving
heavyness	heaviness
hebben	hebbel
hebt	heat
hecho	echo
heckin	checking
hecking	checking
heckkk	heck
hecklin	heckling
heden	helen
heds	he's
hedsers	hedgers
hee	he
heeeee	heeded
heeeey	hereby
heeey	here
heeft	heft
heehee	heeded
heen	been
heey	hey
heh	he
hehe	here
heheh	here
hehehe	helene
hei	he
heibert	herbert
heigth	height
heil	hell
heimliched	heimlich
hej	he
hejsa	he's
hela	help
helaas	hellas
hele	here
helfen	helen
hella	hell
helloo	hello
hellooo	hello
hellzone	hellhole
helmick	hemlock
helo	help
helos	helps
helpede	helped
helpen	helped
helpes	helped
helpfull	helpful
helppp	help
helpss	helps
helpt	help
helpul	helpful
helpzd	helped
helse	else
helsingin	helsinki
helst	heist
helt	help
hemet	helmet
hemetophobia	emetephobia
hemi	hem
hemoroids	hemorrhoids
hemska	hems
henia	hernia
henkel	hence
henne	hence
hennes	rennes
hense	sense
henvender	engender
henvist	hengist
henviste	hengist
hepatologist	hematologist
hepatology	hematology
hered	here
herina	hernia
herinde	heroine
herited	merited
hermana	herman
hermanin	hermann
hermano	herman
herniana	hernia
hernie	hernia
herpulation	serrulation
hert	her
herteg	here
herude	here
hess's	chess's
hestiate	hesitate
hestitate	hesitate
het	he
hete	here
heter	meter
heterotopic	heterotopia
heugh	hugh
heute	here
heya	hey
heyooo	heywood
heyy	hey
heyyy	heavy
heyyyy	heyday
hfl	hel
hfup	up
hgh	high
hh	he
hhmm	hamm
hhmmm	hammy
hhs	his
hiatale	hiatal
hiatel	hiatal
hiatial	hiatal
hiatil	hiatal
hiatual	hiatal
hiburps	hiburp
hicburps	hicburp
hiccaburp	hicburp
hiccaway	hideaway
hicccups	hiccups
hiccupped	hiccuped
hiccupper	hiccuper
hiccuppers	hiccuper
hiccupping	hiccuping
hiccurp	hiccup
hiccurps	hiccups
hice	nice
hiciera	riviera
hickiln's	hickman's
hickin	picking
hickins	picking
hicklen	chicken
hickley	hickey
hicklin	tickling
hicklin's	heckling's
hickling	tickling
hicklins	tickling
hickups	hiccups
hics	his
hicupped	cupped
hicups	hiccups
hicuups	hiccups
hida	hide
hielp	help
hiemlich	heimlich
hier	her
highkey	higher
highmark	highjack
hightened	heightened
higkeit	highest
hihgly	highly
hihi	his
hii	his
hiii	his
hiiii	heidi
hiit	hit
hij	his
hijinx	hiding
hikk	hike
hiklin	violin
hilfe	life
hilwafa	hilwan
hinchaz	whinchat
hinderance	hindrance
hinderered	hindered
hinerance	hindrance
hing	thing
hings	things
hinkin	thinking
hinklin	inkling
hinklin's	inkling's
hinklins	inkling
hipaa	hip
hipcup	hiccup
hipersalivation	hypersalvation
hipo	hip
hippon	hippo
hiraganas	hiragana
hispana	hispania
hispano	hispanic
hist	his
histimine	histamine
histoire	history
historia	historic
historias	historians
historien	historian
hital	vital
hitta	pitta
hiv	his
hiz	his
hizo	his
hj	he
hlt	hit
hlte	hate
hmg	hug
hmmm	hamm
hmmmh	hammy
hmmmm	hammy
hmo	ho
hmos	hos
hmph	humph
hmu	hum
hn	in
hno	no
hnsf	his
hoc	how
hocam	local
hoch	hock
hockin	hocking
hodgie	hoagie
hodophobe	homophobe
hoef	hoof
hoelsi	holes
hoepfully	hopefully
hoesili	horsily
hoesler	holler
hoesli	hoes
hoesly	holy
hoeveel	hovel
hoeven	even
hoever	whoever
hof	of
hoffmann	hoffman
hoger	roger
hoi	how
hola	hold
holde	hold
holded	holed
holdgraf	hologram
holesli	holes
holesly	honestly
holme's	home's
holseley	holley
holsley	holley
holsli	holly
holter	hotter
holyyy	holy
hom	how
homebound	housebound
homegoods	homerooms
homeopathhy	homeopathy
homeschooled	homeschooler
homestuck	homesick
hominem	homing
hominems	hominess
homme	home
homoplates	hotplates
honickman	hickman
honnestly	honestly
honour	honor
honoured	honored
hoochies	pooches
hoodie	goodie
hoodies	goodies
hoofbeats	hoofbeat
hoofd	hood
hoogte	boogie
hooklying	hooking
hooooo	hoodoo
hoopvol	hoopoe
hoor	door
hoort	hoot
hopefull	hopefully
hopen	open
hopfully	hopefully
hopin	hoping
hopital	hospital
hopp	hope
hoppas	poppas
hoppiness	happiness
hoppy	happy
hopsital	hospital
hoquet	coquet
horen	horn
horizonal	horizontal
horizzontally	horizontally
hork	work
hornung	morning
horray	hooray
horrdenous	horrendous
horrendus	horrendous
horribe	horrible
horriblest	horrible
horsies	horses
hortons	horton
hoseli	hotel
hosli	hold
hosp	host
hospitalisation	hospitalization
hospitalisations	hospitalizations
hospitalised	hospitalized
hospitalising	hospitalizing
hosptial	hospital
hostpital	hospital
hotell	hotel
hotellet	hotelier
hotmail	hobnail
hou	you
houden	holden
houdoe	houdon
hourd	hours
hoursss	hours
hovedet	hovered
how'd	how's
how're	how's
howd	how
howeve	however
howz	how
hp	he
hpylori	pylori
hr	he
hra	ha
hradec	headed
href	ref
hren	hen
hrige	high
hrim	him
hrms	arms
hrs	his
hrt	hit
hrv	hrm
hs	is
hsa	has
hsd	had
hsng	hang
hst	hit
hsu	hus
hsve	have
hsvr	have
ht	it
htan	than
hte	the
htp	hop
htting	hitting
hu	he
hu's	he's
hubba	hubby
huberman	superman
huccup	hiccup
huddinge	pudding
huel	fuel
huels	heels
huesos	guess
huffington	huntington
hugee	huge
huhh	huh
huis	his
huisarts	hussars
huit	hit
hullabalooza	hullabaloo
humaine	humane
humana	human
humanidad	humanized
humira	humor
humour	humor
humourous	humorous
hunby	hubby
hunderd	hundred
hundra	tundra
hungier	hunger
hunnnhh	hunnish
hunry	hurry
hur	her
hurlin	hurling
hurp	hurt
hurted	hunted
hurttt	hurt
hurty	hurt
hurwitz	horowitz
hus's	husks
hust	just
hutt	hurt
huuge	huge
huuuge	huge
huuuh	huh
huuuk	hunk
huvud	humid
hvad	had
hve	have
hvem	hem
hver	her
hving	having
hvis	his
hvor	for
hvordan	jordan
hvorfor	horror
hwy	why
hyatt	wyatt
hydralyte	hydrolyte
hydrive	hydride
hydroxyzine	hydrolyzing
hyoscamine	hyoscyamine
hyosciamine	hyoscyamine
hypermesis	hypermedia
hypersalivaion	hypersalvation
hypersalivation	hypersalvation
hypersalvating	hypersalvation
hypersomnia	hypersonic
hypithetical	hypothetical
hyplori	pylori
hypno	hypo
hypochrondriac	hypochondriac
hypocondria	hypochondria
hypocondriac	hypochondriac
hypofunctional	myofunctional
hypontherapy	hypnotherapy
hypotensive	hypertensive
hypothesise	hypothesis
hypothesised	hypothesized
hypothesises	hypothesis's
hypothesising	hypothesizing
hyrogen	hydrogen
hystericus	hysterics
hyv	my
i''d	i'd
i''m	i'm
i'am	i'm
i'lll	i'll
i'mma	i'm
i'n	in
i'ts	it's
iaf	if
iam	am
ianad	canad
iap	map
ias	is
iay	say
ib	i
ibd	i'd
ibgard	board
ibn	in
ibreathe	breathe
ibruprofen	ibuprofen
ibsc	ibs
ibsd	ibs
ic	i
icb	ice
icd	ice
icee	ice
icey	ice
ich	ice
ici	ice
icide	imide
ick	pick
icl	ice
icn	in
icoe	ice
ics	is
icu	ice
id'd	i'd
idag	ida
idc	id
idd	did
idee	idea
ideias	ideas
ideju	idea
idek	idea
ideopathic	idiopathic
idfk	if
idgaf	idea
idiocracy	idiocrasy
idioma	idiom
idk	ink
idky	idly
idr	id
idrk	dirk
ie	i
ieder	seder
iehp	keep
iem	i'm
iemand	demand
ies	is
iets	its
iex	sex
ifbm	ibm
ifld	if
ifr	if
ifra	ira
iftar	after
ig	i
ige	ice
igen	gen
igennem	genned
igenom	venom
ight	right
igjen	given
iglesias	silesias
igs	is
igual	signal
ih	i
ihave	have
ihc	hic
iheart	heart
ihm	him
ihr	ir
ii	i
iii	wii
iiii	mini
iiiis	iris
iike	like
iim	him
iirc	girl
iissues	issues
iit	it
ik	i
ikke	ike
iknow	know
ikr	ike
ikrrr	kerr
il	i
ileocal	local
ilke	like
illl	i'll
ilness	illness
ils	is
im	i
ima	ma
imagen	image
imaginate	imagine
imaginr	imagine
imamu	imam
imc	mic
ime	me
imediate	immediate
imgur	impure
imm	i'm
imma	emma
immagine	imagine
immediat	immediate
immediatley	immediately
immediatly	immediately
immedietly	immediately
immensen	immense
immensly	immensely
immer	simmer
immidiate	immediate
immidiately	immediately
immidiatly	immediately
immobilised	immobilized
immobilises	immobilizes
immodium	imodium
immunosuppressed	immunosuppress
imodiums	imodium
imovie	movie
impacter	impacted
impedence	impudence
implanon	implant
implenet	implant
importan	important
importante	important
imposible	impossible
improoves	improves
improv	improve
improvment	improvement
improvments	improvements
imrovements	improvements
imrpovments	improvements
imsiu	isis
imvoluntary	involuntary
inabilty	inability
inablility	inability
inablity	inability
inbalance	imbalance
inbalnce	imbalance
inbetween	between
inblanced	unbalanced
inbox	into
incapacit	incapacity
incel	intel
incentivized	incentivize
incl	inch
inclusing	including
incluso	include
incomfort	comfort
incomfortable	uncomfortable
incomodas	incommodes
incompitent	incompetent
inconfortable	uncomfortable
inconspicous	inconspicuous
incontrolable	incontrollable
incre	indre
increaser	increase
incredbile	incredible
incredbly	incredibly
incredibily	incredibly
incredilble	incredible
incrementa	incremental
incresed	increased
indd	ind
inde	index
indegestion	indigestion
indepedent	independent
indepth	depth
indescribale	indescribable
indesgestion	indigestion
indgreb	indore
indica	indict
indicitave	indicative
indisgestion	indigestion
individualised	individualized
indo	into
indont	indent
indspr	indoor
indtil	instil
inducirme	inducible
inection	infection
ineed	need
ineffectivity	effectivity
inen	inn
inevidably	inevitably
infact	infant
infecci	infect
infecrion	infection
infiltr	infill
infiltraci	infiltrate
infinitly	infinitely
infinitum	infinite
inflamation	inflammation
inflamatory	inflammatory
inflammed	inflamed
inflexion	inflation
influenca	influence
influencer	influence
influencers	influences
infon	info
informaci	informant
informacion	information
informado	informed
informan	informant
informando	informant
informasjon	information
informations	information
infos	info
infront	front
inga	ing
ingen	inge
ingeniorx	ingenious
inglese	singles
ingredientes	ingredients
ingreep	ingress
inhailers	inhalers
inhalable	incapable
inhaley	inhale
inhalte	inhale
inhilation	inhalation
iniability	inability
inital	initial
initally	initially
iniziale	initial
inj	in
injecitons	injections
injectable	indictable
injectee	injected
injecter	injected
injectie	inject
injest	invest
injextions	injections
injx	in
inklusive	inclusive
inlaws	inlays
inmediate	immediate
inmediatly	immediately
inmiddels	infidels
inmy	inky
inna	inn
innability	inability
innan	incan
inne	nine
innen	inner
innerside	underside
innert	inner
innkalling	installing
inownt	known
inpacto	impact
inpediment	impediment
inprocessing	processing
inprovement	improvement
inputed	inputted
insanly	insanely
inscurance	insurance
insipidus	insidious
insistir	insist
insite	inside
insititute	institute
insitute	institute
insnane	insane
insomia	insomnia
insomnias	insomnia
insruance	insurance
insta	instar
instantan	instant
instensely	intensely
instestine	intestine
instict	instinct
instinctually	instinctual
institutet	institute
instructif	instructed
instrusments	instruments
insturments	instruments
instutute	institute
insuficiency	insufficiency
insurabce	insurance
insuranance	insurance
insurence	insurance
insurrance	insurance
int	in
intaking	taking
intanto	instant
inte	into
intead	instead
intelerance	intolerance
intenionally	intentionally
intens	intend
intensine	intensive
intensines	intensives
intensly	intensely
intenstines	intestines
intenta	intent
intentar	intent
intentas	intents
intented	invented
intento	intent
interesa	interest
interesant	interest
interese	interest
interessted	interested
interestedboy	interestedly
interestibg	interesting
internos	interns
interrim	interim
interroge	interrogate
interruptor	interrupter
intersting	interesting
intertwisted	intertwined
interupted	interrupted
interupting	interrupting
intervenci	intervene
intervenir	intervener
intervento	intervention
interwebs	internees
intestinos	intestines
intestins	intestines
intetesting	interesting
inthe	the
intially	initially
intinctively	instinctively
intol	into
intolerances	intolerance
intolerancias	intolerance's
intolerante	intolerant
intolerence	intolerance
intollerance	intolerance
intorelance	intolerance
intra	infra
intresse	increase
intrested	interested
intresting	interesting
intro	into
introductury	introductory
intubated	intubate
intubating	incubating
intubation	incubation
intubations	incubation
invalidanti	invalidate
invasiveness	evasiveness
invece	invite
invermere	interfere
investigational	investigation
invisable	invisible
invitacion	invitation
invito	invite
involountarily	involuntarily
involunarily	involuntarily
inyeccion	infection
inyect	inject
inyected	infected
inyecting	injecting
inyection	infection
inyections	injections
iol	oil
ionly	only
ip	i
ipa	spa
ipas	pas
iper	per
ipf	if
iphones	phones
iq	i
iqoro	ivory
iques	piques
irb	rib
irccs	circus
irei	ire
iri	iris
irme	ire
irn	in
iro	iron
ironman	iranian
ironmans	romans
irp	rip
irre	ire
irren	green
irritables	irritable
irs	is
isch	inch
ish	is
isint	isn't
isn	in
isngreat	intreat
isnt	isn't
iso	is
isso	is
isssue	issue
issu	issue
issuea	issue
issuses	issues
ist	is
istantly	instantly
istituto	institute
isues	issues
isy	is
it't	it's
itake	take
italiana	italian
italiano	italian
itd	it
ith	it
itidine	iodine
itis	it's
itll	i'll
itlooks	looks
itnended	intended
itno	into
itol	idol
itsself	itself
ittt	it
itttt	titty
itty	kitty
itv	it
itwas	twas
ity	it
itz	it
iu	i
iu's	it's
iud	i'd
iuds	buds
iv	i
ivc	vic
ive	give
iversary	adversary
ivey	ivy
ivf	if
ivr	ivy
ivs	is
iykyk	icky
iys	is
j'ai	jail
j'arrive	arrive
j'avais	java's
j'en	e'en
j'esp	jeep
j'essaie	jessie
j'imagine	imagine
jaaaa	jamal
jaar	jar
jabba	abba
jabbour	jabber
jacqui	jacque
jad	had
jadore	adore
jagt	jag
jaha	aha
jahren	barren
jai	jail
jaja	raja
jajaja	pajama
jak	jam
jakim	hakim
jakob	jacob
jalape	jalap
jalapeno	jalapeño
jama	mama
jamais	mama's
jamba	samba
janes	jane
jank	bank
janky	hanky
janvier	javier
jaqui	yaqui
jarige	large
jasmeen	jasmine
jawache	apache
jax	tax
jayhur	ashur
jci	ci
jd	ad
je	we
jear	hear
jebus	jesus
jeddah	jedda
jeden	eden
jedes	jades
jednej	jenner
jedno	jeans
jedoch	epoch
jeej	jeep
jeesus	jesus
jefferys	jeffery
jeg	beg
jeje	jefe
jejeje	jejune
jelle	jelly
jemand	demand
jen	men
jenevers	jewelers
jeniffer	jenifer
jenks	jerks
jennelle	janelle
jenvoice	invoice
jeopardising	jeopardizing
jesper	jester
jestem	jester
jetzt	jet
jeudi	jedi
jewellery	jeweller
jezelf	jewels
jfc	jfk
jgravid	gravid
jiang	kiang
jic	vic
jiddra	jidda
jij	jim
jimi	jim
jin	in
jippi	lippi
jist	just
jitsu	its
jiu	jim
jizz	jazz
jjst	just
jk	ok
jkssss	jess's
jlcfy	jiffy
jlighet	light
jligt	light
jn	in
jnfo	info
joao	joan
jobbar	jobber
jobbigt	hobbit
jobhunting	foxhunting
joggings	jogging
joghurt	yoghurt
joh	oh
jolie	julie
jong	long
jordz	word
jothi	both
jou	you
joue	joke
jouney	journey
jour	your
journ	mourn
journaling	journalling
jours	hours
joyy	joy
jp	up
jpg	jog
jpg's	jig's
jpy	joy
js	is
jskoker	joker
jsut	just
jt	it
jts	its
ju	u
juast	just
juat	just
juddery	judder
juicebox	jukebox
juin	join
juist	just
juiste	just
juli	julia
jullie	julie
jum	jump
jumpstart	upstart
jumpstarted	upstarted
juni	junk
jup	up
juran	juan
jurjaan	juryman
juro	jury
jurrasic	jurassic
jus	just
jusr	just
juste	just
justed	busted
justicier	justiciar
justttt	justest
justturn	outturn
jusy	just
juul	jul
juuust	just
kacey's	kasey's
kalash	calash
kalle	kale
kallelse	alleles
kambo	mambo
kamera	camera
kamp	camp
kann	ann
kannst	cannot
kannte	karate
kanske	kansas
kao	ka
kapalu	papal
karagam	karajan
karagama	karaganda
karagamma	karaganda
karagarma	karaganda
karagma	karma
karangwa	kananga
kare	are
kargama	karma
karna	karma
karting	parting
karunga	kahuna
kary	mary
kasier	easier
kassen	kassel
kathan	nathan
katheter	catheter
kauf	kaif
ke	we
keast	least
keds	kids
keeep	keep
keeo	keep
keepin	keeping
keer	keep
kefir	kafir
kegals	legals
kegels	keels
kegger	egger
keifer	heifer
kein	keen
keine	seine
keinen	keen
kelowna	kolomna
kelser	keller
kenalog	analog
kenco	kendo
kende	kendo
kendisi	kentish
kennen	kennel
ker	her
kere	were
kerokan	keresan
ket	get
ketamine	etamine
keto	veto
ketochow	kiaochow
keton	keaton
keyholder	keyhole
kg	keg
kgs	kegs
khco	who
kickar	kicker
kickass	kicks
kickin	kicking
kicklin	kicking
kickstarted	kickstart
kieran	kievan
kies	kids
kigt	kit
kiiind	kind
kijk	kick
kijken	kicked
kilometres	kilometers
kimmel	kümmel
kindergarden	kindergarten
kindof	kind
kindve	kindle
kinesiologo	kinesiology
kins	kind
kippt	kept
kirklin	firkin
kirurg	kiruna
kissy	kiss
kitkat	diktat
kk	ok
kke	ike
klaar	clear
klar	klan
klarer	later
klaret	claret
klart	kmart
klasse	class
kleine	klein
kleins	klein
kliniek	kline
klinik	link
klinkt	link
klippel	slipped
klo	lo
kloppen	flopped
klopt	lot
klote	love
klotz	klutz
km	am
kmh	kph
kmr	kor
kms	ems
kn	in
knas	anas
knawing	knowing
kneep	keep
knews	knew
knie	knife
knifelike	lifelike
kningar	ningal
kningen	klingon
knkw	know
kno	know
knome	gnome
knopen	open
knor	know
knowleable	knowable
knowledgable	knowledgeable
knowlingly	knowingly
knowong	knowing
knowww	know
knowwww	knowhow
knurren	knudsen
knwo	know
knwoledge	knowledge
ko	to
kohles	kohls
kohli	kohl
kohm	kohl
kom	mom
komen	women
komma	momma
komme	somme
kommen	women
kommer	summer
kommor	common
kommt	commit
komplett	complete
komt	komi
kon	on
konking	honking
konnte	donate
konsistent	consistent
konsyl	consul
kontakt	contact
kontrollera	controller
kool	cool
koppig	popping
kore	more
korrekt	correct
kort	sort
korte	forte
kost	most
kostar	costar
koste	coste
kosten	listen
koster	foster
kostet	foster
kotsen	gotten
koufman	kaufman
koufman's	kaufman's
kp	up
kpop	pop
kracht	yacht
kraju	raj
kreeg	keep
krijg	bring
krijgen	kristen
krisp	crisp
krispies	crispier
kristoff	kissoff
krisztike	kristine
kroket	broke
krop	drop
kroppen	dropped
kta	ta
ktc	kc
ktcing	thing
kte	ate
ku	u
kuch	much
kuddos	kudos
kuderer	murderer
kul	kun
kull	kill
kult	cult
kumar	human
kunde	kind
kunna	kuna
kunne	dunne
kunnen	tunnel
kunnet	punnet
kunt	hunt
kuopion	kuopio
kupfer	super
kupfer's	supper's
kupperman	superman
kurere	purer
kurert	purest
kurz	kurt
kvalm	calm
kvar	var
kwaja	kara
kwam	swam
kwamen	women
kwijt	twist
kwinn	kind
kyiv	kid
kylie	kyle
kys	keys
l'ai	lead
l'aide	laid
l'air	lair
l'alto	alto
l'autre	lautrec
l'eau	lead
l'h	l's
l'id	laid
l'impression	impression
l'injection	injection
l'intervention	intervention
l'll	i'll
l'occasion	occasion
l'op	loop
l'orl	lord
l'ugola	plugola
l'un	run
l've	love
laan	loan
laat	last
laatste	latte
laboral	aboral
labour	labor
laboured	labored
labourer	laborer
labours	labors
lactaid	lactic
lacto	last
lactosa	lactose
lado	lady
lados	lads
ladt	last
laer	later
laeyngeal	laryngeal
lai	law
laissais	alissa's
laks	laws
lallergies	allergies
lamc	lame
landen	landed
landet	landed
lange	large
langem	langer
langt	lang
laparoscop	laparoscope
laparotom	laparotomy
laplaces	laplace
laprascopy	laparoscopy
larangeal	laryngeal
laranyx	larynx
largar	larger
laringe	larine
larnxy	larry
larnyx	larynx
laryg	lady
larygnoscope	laryngoscope
larygnoscopy	laryngoscopy
laryngal	laryngeal
laryngo	larynx
laryngolist	laryngologist
laryngolog	laryngology
laryngologist's	laryngologist
laryngologists	laryngologist
laryngoscopic	laryngoscope
laryngoscopie	laryngoscope
laryngoscopies	laryngoscopes
laryngscopy	laryngoscopy
larynogoscopes	laryngoscopes
larynology	laryngology
larynthologist	laryngologist
laryt	last
las	was
lasciato	fasciate
lasered	layered
lasik	laski
laso	last
lastig	lasting
lastiger	nastier
lastigste	castigate
latam	lactam
laten	late
lates	late
latinoam	latino
laufe	laue
laught	caught
lavaughn	vaughn
lavede	laved
lavet	lave
lawed	laced
laxtives	laxatives
laye	late
layed	played
layrnx	larynx
lazzes	jazzes
lb	la
lber	leer
lbs	labs
lbvs	lavs
lc	la
ldigt	light
ldl	ld
lds	lads
leahy	leaky
leandro	leaner
leant	least
leared	learned
learnable	bearable
learnings	learning
leatherwork	leatherwood
leawood	seafood
lebens	levels
leclerc	lecher
lecroix	lacroix
lectin	lection
lectins	letting
lectrodes	electrodes
leden	laden
leder	leader
leeg	leg
leen	been
lege	legs
legen	legend
legge	ledge
leggen	legged
leggi	leggy
legitimise	legitimize
legos	legs
leichte	fichte
leide	eide
leider	leader
leido	lido
lejano	lean
lejos	lajos
lekarzy	leary
leken	liken
lekker	leaker
lemini	gemini
lemmy	lemme
lenge	ledge
lengua	lingua
lenguaje	language
lennox	lennon
lenox	leno
lense	sense
lente	lent
leonards	leopards
leondards	leopards
leppan	lean
lerner's	learner's
lesd	less
lese	else
lessend	lessen
lessness	lessens
lessoning	lessening
letar	lear
letargic	lethargic
leting	letting
letss	let's
letto	lotto
lettre	letter
leur	lemur
leuten	lenten
leuven	leaven
leve	love
levou	level
lex	let
lexium	medium
lf	of
lft	let
lg	la
lgbt	get
lgelig	gelid
lh	oh
liaguris	liguria
liberazione	liberation
libo	limo
libre	lire
licitation	limitation
licor	lictor
licour	liquor
lidiar	lidia
lidocain	lidocaine
lidt	list
lieing	living
lieus	lies
lieve	live
lifegoals	lifeboats
lifes	life
lige	like
ligge	liege
ligner	linger
ligt	light
liife	life
liitttle	little
lije	like
lijken	liken
lijst	list
lik	like
likelyhood	likelihood
likey	like
likly	likely
lil	lie
lile	like
lilely	likely
lilkely	likely
limonine	limonene
lindt	linda
ling	long
linkedin	linked
linkjes	likes
linley	finley
linning	winning
linzess	lines
lior	lion
lioration	libration
liorations	locations
liore	lire
liorer	lower
lipsinc	lisping
liqiuids	liquids
liqour	liquor
liquidish	liquids
liquidy	liquid
liquorice	licorice
lisano	pisano
lisant	list
lista	list
listeing	listening
listmaker	mistaker
literatures	literature
litet	liter
lithos	pithos
litres	liters
litt	list
litterally	literally
litteraly	literally
littles	little
litttle	little
liu	lie
liv	live
livet	live
livsl	live
liying	living
ljr	lar
ljudi	judi
lk	la
lkast	last
ll	all
llamado	llama
llaman	llama
lld	old
lle	lie
llega	legal
llegar	alegar
llego	lego
lleno	leno
ller	leer
llet	let
lleva	leva
llevas	fleas
lleve	love
llevele	level
llig	long
llike	like
lliterally	literally
lmao	lao
lmaoo	loo
lmaooo	magoo
lmfao	lao
lmk	lek
lmnt	lent
lmonger	longer
loa	lot
loada	load
loadsss	loads
loca	local
localised	localized
locateed	located
lockdowns	lockdown
lodon	london
loe	love
lofflex	coffle
loga	log
logica	logical
logicial	logical
logr	log
logrado	dorado
logras	lords
logro	logo
lohnt	long
loius	lotus
loius's	locus's
loko	look
lolll	lolly
lollll	lolly
lollz	lolly
lolol	loll
lololol	lollop
lols	lots
londra	sondra
londres	wonders
longers	longer
longgg	long
longggg	longing
longstand	longhand
longterm	longer
longues	tongues
longuest	longest
longum	long
lonnng	long
lontano	montana
looch	pooch
loogie	boogie
loogies	loonies
lookin	looking
lookind	looking
lookup	lockup
looky	look
lool	look
loomis	looms
loompa	loop
loong	long
loool	look
looong	long
looool	googol
loooong	looking
looooot	lookout
loooot	lookout
loooots	lookouts
loooott	lookout
looopy	loopy
looot	loot
looots	loots
looove	love
loooves	loves
loopt	loop
loosey	loose
loove	love
lorde	lord
lordy	lord
loro	lord
lorsque	mosque
los	lot
losec	lose
losen	lose
losens	loses
lossen	loosen
lossening	loosening
lossing	losing
lotsa	lots
lotsof	lots
lottt	lotta
lotttt	lotta
loud'd	you'd
loud'ed	loaded
loudert	louder
louisus	louis
lound	found
louness	loudness
loungebra's	lounger's
lourd	loud
lov	love
lovad	loved
lovar	lover
loveee	love
lovehate	lovelace
lowfod	lowed
lowk	look
lowkey	looked
lp	up
lpa	la
lpe	lie
lpr	lar
lps	lips
lpsen	open
lpst	last
lpt	let
lqoro	lord
lsd	led
lsom	loom
lstick	stick
ltima	lima
ltimo	limo
ltl	lt
ltos	lots
lubricanted	lubricated
luc	luck
luccas	lucas
lucht	much
lucie	lucid
luciky	lucky
luckely	luckily
luckly	lucky
lucys	lucas
luego	lego
luft	left
lugar	sugar
lugee	luge
lugnar	lunar
lugy	lug
lui	li
lukken	sunken
lukker	lurker
lukt	lust
lukte	luke
lumb	dumb
lund	land
lurping	lurking
luska	lusaka
luta	lute
lutch	lunch
lv	la
lva	la
lvhn	even
ly	my
lyc	lye
lycka	lycra
lyckade	blockade
lyckat	locket
lyckats	lockets
lyde	lyle
lyder	ryder
lyfe	life
lyft	left
lyk	lye
lykke	like
lykkes	likes
lymes	limes
lymphocytic	lymphocyte
lyndsay	lindsay
lynked	linked
lyst	last
m'a	ma
m'aide	made
m'aider	maiden
m'arr	marry
m'en	men
m'excuse	excuse
m'ont	mont
m'y	my
maaaaan	malayan
maaaan	madman
maaan	mayan
maaany	many
maaaybe	maybe
maag	maas
maand	maund
maandag	amanda
maanden	maiden
maandje	mande
maar	mar
maargoed	embargoed
mabye	maybe
maccas	macias
macdonalds	macdonald
machen	aachen
machs	macho
macht	yacht
macomb	comb
macquarie	jacquerie
macroburps	macroburp
madddd	added
mades	made
madibee	mandible
madlad	salad
mag	man
magister	magistery
mago	ago
mahalo	halo
mailade	mailed
mailen	maiden
mailley	valley
mailly	mainly
mailto	mail
maing	making
mainka	main
maintenant	maintenance
maintenence	maintenance
mainy	many
mais	main
majes	makes
majorit	majority
makec	make
makedonija	macedonia
maken	make
makeout	takeout
mal	man
mala	male
maladie	maladies
malaisey	malaise
malas	males
malasana	mahayana
malditos	maldives
malinga	malinda
malnati	magnate
malnatis	mantis
mals	male
mals's	male's
mamama	mamma
mammometry	manometry
mammotry	mammoth
mamometry	manometry
mamy	many
managable	manageable
manageble	manageable
managment	management
manch	match
mandado	manado
mandalo	mandala
mandame	madame
mando	mango
manera	mantra
maneuvre	maneuver
manged	managed
manier	manner
manish	vanish
manja	mana
mannitol	manitou
mannnn	manner
mannography	macrography
mannometry	manometry
mannommetry	manometry
mannually	manually
manny	many
mannyy	many
mano	man
manoeuvre	maneuver
manom	manor
manomatry	manometry
manomentry	manometry
manometey	manometry
manometri	manometry
manometrie	manometric
manometries	manometers
manomotry	manometry
manonetry	manometry
manos	man's
manouver	maneuver
manouvering	maneuvering
manouvre	maneuver
manualities	banalities
manuever	maneuver
manuka	hanuka
manuver	maneuver
mapa	map
marajuana	marijuana
marcelle	marcella
marchera	marchers
mardi	mari
marea	area
marfans	marfan
margol	margot
margs	marks
maritimes	maritime
markus	marks
marky	marry
marriot	marriott
marsk	mark
martes	mates
marvellous	marvelous
marzo	mario
mashable	washable
masive	massive
massa	mass
massager	massage
massagers	massages
masterlist	pastelist
mastros	maestros
masuk	mask
matarme	mature
matcha	match
mater's	water's
maths	math
matirka	mazurka
matrka	marka
mau	man
maugeri	mauger
mauvais	mavis
maux	max
maximaal	maximal
maxime	maxim
maximise	maximize
maxx	max
maybee	maybe
maybeee	maybe
mayy	many
mayybe	maybe
mayyy	maybe
mayyybe	maybe
maz	man
mazori	maori
mbct	but
mbd	mad
mbers	embers
mblez	able
mbs	mes
mbss	miss
mc	my
mcalister's	canister's
mcas	mas
mccune	accuse
mcdonalds	mcdonald's
mcds	mods
mcg	mug
mcgarey	carey
mcgill	chill
mch	much
mchugh	cough
mchughs	coughs
mckinnon	mckinney
mcmaster	master
mcp	map
mctd	mind
mcu	mu
mcw	mow
mdc	mic
mdcs	mics
mdd	mad
mdl	mil
mdma	mama
mds	ads
mdsc	must
mea	me
meacham	beecham
meannn	mean
mebeverine	bebeerine
mecanism	mechanism
mecfs	means
mecham	mocha
med	me
meda	media
medboard	keyboard
medcline	medicine
medcost	redcoat
medecine	medicine
medeo	mede
medford	bedford
medi	media
medibank	median
medicaci	medical
medicade	medicate
medicamentos	medicament's
medicash	medical
mediciations	medications
medicin	medicine
medicina	medicine
medicinals	medicinal
medicinee	medicine
medicinsk	medicine
mediction	medication
medida	media
medio	media
medisch	medic
meditacion	meditation
medivacation	medication
medixal	medical
meds	mess
medscape	escape
medsurg	measure
mee	me
meee	meet
meeee	meet
meeeee	peewee
meei	meet
meen	been
meer	meet
meestal	mental
meeste	meet
meeth	meet
meetup	meet
meetups	meets
megaburp	megabuck
megaburps	megabucks
megapost	megadose
megathread	meathead
meget	meet
meglumine	melamine
meh	me
mehil	evil
mehr	lehr
mei	me
meilleur	miller
mein	mean
meine	mine
meinem	eminem
meiner	meaner
meines	mines
meinte	meant
meiste	mister
mejl	meal
mejla	mejia
mejor	major
mejora	major
mek	me
melasma	melisma
melb	melt
melbent	relent
melborne	melbourne
melborune	melbourne
melboune	melbourne
meldet	melded
mello	hello
melodica	melodic
melodramtic	melodramatic
meltlet	melted
meltlets	pellets
memes	memos
memorised	memorized
memorizations	memorization
mendelhson	mendelssohn
mendelshon	mendelssohn
mendelsohn	mendelssohn
meningen	meninges
menometry	manometry
menos	menus
mens	men
mensaje	message
mensen	jensen
menstration	menstruation
mensturate	menstruate
ment	went
mentaires	centares
mentaly	mental
menthe	months
menthod	method
mentionned	mentioned
mentionning	mentioning
mentoning	mentioning
mentos	mentor
menty	meaty
meps	mess
mer	me
meralgia	metralgia
merati	meat
merch	mercy
merci	mercy
mercola	merca
merda	merca
meremans	germans
merica	america
merifully	mercifully
meriter	merited
merlan	merman
mesec	mesic
meself	myself
mesenteric	dysenteric
meses	mess
mesmo	memo
messure	measure
mest	must
mestinon	mention
metabolised	metabolized
metabolises	metabolizes
metabolizer	metabolize
metalhead	meathead
meteen	between
meth	met
methode	method
metodo	method
metres	meters
metry	merry
mettre	mettle
meus	mess
mevoc	memo
mexium	medium
mf'er	after
mfg	mug
mfter	after
mgb	mob
mgh	ugh
mgs	mugs
mgx	mix
mhch	much
mhd	mad
mhm	mom
mhmm	hmm
mhra	mara
mhs	mes
miagi	miami
mib	mix
miccat	wiccan
michael's	micheal's
michaels	michael
michals	michael
micheals	micheal
michels	michel
mico	mice
micoburp	microburp
micoburped	microburped
micoburps	microburps
micorburp	microburp
micrburps	microburps
micro'd	micro's
micro'ish	micro's
microbiome	microsome
microbiomes	microsomes
microbirps	microburps
microbrup	microburp
microbrups	microburps
microbumps	microburps
microbups	microbus
microburbs	microburps
microburper	microburped
microbursts	microburst
micronutrients	micronutrient
micropburp	microburp
micropburps	microburps
midchest	richest
middlebrough	middlesbrough
middway	midday
midpole	middle
midrange	mirage
midsts	midst
midvale	middle
miejsc	miens
mientras	mantras
mierda	mired
mieux	mix
migh	might
might've	might's
mighttt	might
mightve	might
migrain	migraine
migranes	migrants
migriane	migraine
miiiight	midnight
miiini	mining
mij	mix
mijn	min
milage	mileage
milano	milan
milanos	milan's
mildy	mild
miljard	millard
mille	mile
millenials	millennial
millennials	millennial
milli	mill
milliers	millers
millimetre	millimeter
mimick	mimic
mimicks	mimics
mindblown	windblown
mindre	minder
mineur	miner
minha	mina
miniburp	minibus
miniburps	minibus
minimalize	minimize
minimaly	minimal
minimise	minimize
minimised	minimized
minimising	minimizing
minimizng	minimizing
minimoon	minion
minimzes	minimizes
minits	mints
minns	minds
minorly	minor
minoru	minor
minr	mind
mins	mind
mintec	minted
minth	month
mintutes	minutes
minut	minute
minutos	minutes
minuttes	minutes
minuutjes	minutes
mio	mix
miotom	motor
miotomy	myotomy
mirando	miranda
mirara	tiara
mirco	micro
mircoburp	microburp
mircoburps	microburps
mircorburps	microburps
mircro	micro
miread	misread
mirelax	relax
mirena	siren
mirrior	mirror
mis	is
misaligenment	misalignment
misbalance	imbalance
misc	miss
miscommunications	miscommunication
miscroburps	microburps
miserables	miserable
mishaped	misshaped
misma	miasma
mismas	miasmas
mismo	miso
misphonia	dysphonia
misschien	mischief
missdiagnosed	misdiagnosed
missunderstood	misunderstood
miste	mister
mistenkes	mistakes
misworded	discorded
mited	mixed
mitigations	mitigation
miting	mining
mito	mit
miyagi	miami
mj	my
mjolnir	molnar
mkt	met
ml	my
mls	mes
mm	my
mma	mama
mmg	mug
mmhg	mug
mmhm	mom
mmm	mom
mmmh	much
mmmm	mom
mmmmm	mommy
mnd	and
mnde	made
mngi	magi
mnogo	mongo
moar	roar
moastly	mostly
mobeth	mouth
mobilisation	mobilization
mobilises	mobilizes
mobilising	mobilizing
moby	mob
mochaco	mocha
mocht	mocha
mocktail	cocktail
mocktails	cocktails
moda	soda
modding	sodding
modelare	moderate
modelo	model
moderna	modern
modo	mood
moed	moved
moeite	movie
moest	most
moeten	molten
mofo	mojo
mogen	imogen
moh	oh
moignages	coinages
moin	join
moines	mines
moing	going
moins	coins
mois	moms
moiti	most
mojito	monitor
mojitos	monitor
mok	mom
molesta	molest
molestias	molesting
molestos	molests
moley	money
molors	colors
molson	jolson
molto	motto
momentan	momenta
momentos	moments
monash	monas
monate	donate
monaten	monster
mond	mind
mondayxx	monday
mondino	minding
mondo	condo
monetario	monetary
monologuing	monologuist
monomatry	monolatry
monomentry	manometry
monomerry	manometry
monometry	manometry
monomotry	manometry
monsterous	monstrous
montag	montage
montake	montage
montha	months
monthes	months
monton	wonton
montr	month
montrealer	montreal
montrer	mother
monzo	mono
moocar	oscar
mooi	moon
moom	room
mooshy	moose
moozart	mozart
mor	for
morbidities	mobilities
morbing	morning
moreso	mores
mori	more
moritifed	mortified
morph	morphs
morpheiene	morphine
mortem	more
mortensen	hortense
morty	forty
morzaria	moravia
mos	most
moscato	muscat
moscatos	muscat's
moslim	muslim
mosr	most
mostlty	mostly
mostr	most
mostrato	castrato
mostrei	costrel
motegrity	integrity
mothefucker	motherfucker
motilium	motility
motnh	month
moto	motor
motocycle	motorcycle
motrins	motrin
mould	would
mourh	mouth
mout	out
mouthfeel	mouthful
mouthfull	mouthful
mouthfulls	mouthfuls
movember	november
movenent	movement
movin	moving
moytomy	myotomy
mp	my
mpb	mob
mpoint	point
mps	maps
mpw	mow
mre	me
mres	mes
mris	iris
mroe	more
mrsa	mesa
mrw	mow
msc	mic
msgs	mugs
mske	make
mskes	makes
mslt	melt
msm	mom
msn	man
msp	map
msyelf	myself
mtb	mob
mtd	mad
mth	math
mthf	the
mthfr	other
mths	myths
mtl	mil
mtn	man
mto	to
mty	my
muay	may
mubmo	mum
mucas	lucas
mucha	much
muchas	much's
mucho	much
muchos	much's
mucinex	mucin
mucles	muscles
mucosal	mucosa
mucosta	mucosa
mucousy	mucous
mucroburp	macroburp
mucusy	mucus
mucusyy	mucus
mudanza	mwanza
mudruns	gudrun
mufasa	mucosa
mui	mum
muito	quito
mukbang	mustang
mulig	music
muligt	juliet
mulitple	multiple
mullers	millers
multi	mufti
multicenter	multimeter
multicoloured	multicolored
multipack	multitask
multiplan	multiple
multivit	multifid
munche	munch
mund	mind
mundo	undo
muren	mure
murty	murky
musc	must
muscels	muscles
muschle	muscle
musclular	muscular
muscolo	muscle
mushies	mashies
musinex	musing
muskel	musket
muskeln	musket
muskle	muscle
muslce	muscle
musle	muscle
musles	muscles
musste	musset
must've	must's
mustn	must
mustve	mustee
mutanying	mutinying
mutiple	multiple
mutliple	multiple
mutltiple	multiple
mutualite	mutuality
mutuals	mutual
mutuelle	mutually
muy	my
muzzali	muzzle
mvg	mug
mvp	map
mvps	maps
mw	my
mx	my
mybloc	bloc
mychart	chart
mycket	market
mydayis	mayday's
mye	my
myhealth	health
mylanta	manta
mylicon	silicon
mymotomy	myotomy
myo	my
myoclonic	cyclonic
myocyte	monocyte
myopathy	sympathy
myostomy	myotomy
myotmy	myotomy
myotomie	myotome
myotomies	myologies
myotonic	myotonia
myotymy	myotomy
mysery	mystery
mythroat	throat
mytomy	myotomy
myupper	upper
myyy	my
n'a	na
n'ai	near
n'as	n's
n'avez	navel
n'en	e'en
n'es	noes
n'est	nest
n'h	nah
n'ont	not
n'stuff	stuff
n't	not
n'y	nay
naam	nam
naar	near
naast	last
nac	na
nach	each
nacht	yacht
nacine	nadine
nacl	nail
nad	and
nada	nara
nadal	naval
nadhim	nadia
nadie	sadie
nadu	and
naeusea	nausea
nafld	named
nagatos	negates
naher	nader
naief	naif
nailbeds	nailed
nano	kano
nant	want
nao	no
napa	papa
napisa	rapist
nar	car
narcan	nathan
narcissits	narcissist
narcisstic	narcissistic
narco	narc
nare	are
naren	karen
narkos	nark's
narkose	arkose
narkosen	arkose
narly	early
nas	was
naseau	nassau
naseaus	nauseous
nasen	nansen
nasendoscopy	nasoendoscopy
naseous	nauseous
naseua	nashua
naseuous	nauseous
naseus	name's
nasolaryngoscopy	nasopharyngoscopy
nasopharyngoscopes	nasopharyngoscope
nasr	nash
nasuea	nausea
natals	natal
nationella	nationally
natropath	naturopath
natten	fatten
naturaleza	naturalize
naturality	naturally
naturaly	natural
natutally	naturally
nauceous	nauseous
naucious	cautious
naunheim	mannheim
naunheim's	mannheim's
naus	nous
nausa	nausea
nausate	nauseate
nauscious	luscious
nause	cause
nauseacous	nauseous
nauseam	nausea
nauseant	nausea
nauseaous	nauseous
nauseas	nausea
nauseaus	nauseous
nauses	causes
nauseus	nauseous
nausheen	dasheen
nausia	nausea
nausious	nauseous
nausous	nauseous
naussea	nausea
nautious	cautious
nauzene	nadene
nav	na
navitus	davits
naw	now
nawet	name
nawing	naming
naww	now
naysay	nasty
nba	na
nbd	nod
nbs	abs
nbsp	nose
nc	no
ncbi	ni
nccp	nice
nda	na
ndag	nag
nde	de
nden	den
ndependent	independent
ndes	nodes
ndoles	doles
ndolo	nolo
ndome	dome
ndrat	drat
ndringer	ringer
ndung	dung
neanche	blanche
neasea	ease
neaseous	nauseous
neast	least
neausea	nausea
neauseaous	nauseous
neauseas	nausea
neauses	neguses
neausous	nauseous
nebulizers	nebulizer
neccesary	necessary
neccessary	necessary
neccessity	necessity
necesairly	necessarily
necesarily	necessarily
necesary	necessary
necesite	necessity
necesito	necessity
necesity	necessity
necess	recess
necessairy	necessary
necessasrily	necessarily
neckaches	necklaces
necro	negro
nede	need
neder	never
nederland	gelderland
nederlander	netherlander
nederlands	netherlands
nee	see
needa	need
needd	need
neeed	need
neem	need
neen	been
negativos	negatives
negging	begging
negronis	negroni
negstivr	negative
nei	new
neices	nieces
neighbour	neighbor
neighbourhood	neighborhood
neighbouring	neighboring
neighbours	neighbors
neilmed	nailed
nej	new
nek	new
neka	neva
nekkid	nikki
neko	nero
neku	need
nel	new
nella	fella
nemen	semen
ner	her
nerfed	nerved
nergie	nerve
nerherlands	netherlands
nerver	never
nervewracking	nerveracking
nervosa	nervous
nervosity	verbosity
nerwork	network
nes	new
nescesaary	necessary
nescessary	necessary
nese	nose
nesh	nest
nesten	nested
nesthesia	anesthesia
neti	net
netter	better
neuen	been
neurol	neural
neuroligist	neurologist
neurologico	neurologic
neuronox	neurons
neuropathic	neuropathy
neuropsychiatric	neuropsychiatries
neurosym	neurosis
neurotoxic	neurotic
neus	news
neutralise	neutralize
neutralised	neutralized
neutralisers	neutralizers
neutralises	neutralizes
neutralising	neutralizing
neverending	reverencing
neverous	feverous
newburpers	noburpers
nexercises	exercises
nexium	medium
nf	of
nfl	nil
ng	no
nga	na
ngd	nod
nger	anger
ngl	nil
ngo	no
ngst	nest
ngt	not
nh	no
nhl	nil
nhss	ness
nial	nail
niave	naive
nic	nice
nica	nice
nicee	nice
nicht	night
nichts	nights
nico	nice
nicollet	nicole
nicotinate	nicotine
nicotinic	nicotine
nicu	nice
niddle	middle
nie	nice
niema	niece
niet	net
niets	nets
nieuw	new
nieuwe	niece
nigdzie	nightie
nighter	fighter
nighters	fighters
nightime	nighttime
nightimte	nighttime
nightmareish	nightmarish
nigiri	nilgiri
nigth	night
nih	ni
niiice	nice
nije	nice
nikke	nikki
niks	nicks
nikt	nit
nimi	mimi
nimmst	nicest
ning	sing
ningun	injun
ninguna	lingua
ninguno	ningpo
ninsen	finsen
nirpinv	nipping
nisso	miss
nista	vista
nitronated	intonated
nitros	nitrous
niveau	nivea
niw	now
nizac	nina
nj	no
njection	injection
nkat	neat
nken	ken
nker	naker
nko	no
nkt	not
nky	sky
nl	no
nlp	nap
nm	no
nmn	non
nn	in
nnande	inane
nnen	one
nner	inner
nning	inning
nns	nuns
nnte	note
nnu	nun
nobpurp	noburp
nobrup	noburp
nobup	noburp
nobupers	noburpers
noburb	noburp
noburp'er	noburpers
noburp'ers	noburpers
noburpbs	noburp
noburper	noburpers
noburper's	noburpers
noburperuk	noburpers
noburperz	noburpers
noburpes	noburpers
noburping	burping
noburps	noburp
noburpy	noburp
noburup	noburp
nobutp	noburp
nobyrp	noburp
noca	nova
nocal	local
noch	notch
nochmal	normal
nodig	nodi
noemen	nomen
noen	none
nofart	fart
nogal	nodal
nogen	nomen
noget	nonet
nogle	noble
noice	nice
noices	voices
noir	nor
noisers	noises
noisey	noise
nok	not
nolonger	longer
nom	not
nomatter	matter
nombre	hombre
nomerous	numerous
nonburp	noburp
nonburper	noburpers
nonburpers	noburpers
nonesense	nonsense
nonethless	nonetheless
nonflavored	unflavored
nonforced	enforced
nono	none
nonodorous	inodorous
nonsatisfactory	unsatisfactory
nonvoluntary	involuntary
noo	not
noob	noon
noobs	boobs
nooit	not
noone	none
nooners	sooner
nooo	noon
noooo	noon
nooooo	voodoo
noot	not
nootropic	eolotropic
noott	not
noped	hoped
nopop	pop
norburp	noburp
norcal	normal
norco	force
nord	word
noreply	reply
normaal	normal
normale	normal
normalen	normal
normaler	normal
normales	normals
normalisation	normalization
normalise	normalize
normalised	normalized
normalises	normalizes
normalish	normality
normalising	normalizing
normaliza	normalize
normaly	normal
normie	dormie
normies	worries
nornal	normal
nornally	normally
noro	nor
norsk	norse
norweigan	norwegian
nos	not
nosering	covering
nosies	noises
nosis	noses
notaliving	nonliving
nothigg	nothing
nothijg	nothing
nothin	nothing
nothinf	nothing
noticable	noticeable
noticably	noticeably
noticd	notice
noticia	notice
noticias	noticing
noticible	noticeable
noticibly	noticeably
noticied	noticed
notif	notify
notjing	nothing
noto	not
notre	note
nots	not
nou	you
noumereus	numerous
nourris	norris
nouveau	couteau
nouvelle	novelle
nouvelles	novellas
novacaine	novocaine
novedad	notepad
novocane	novocaine
novomit	vomit
novomiter	vomiter
nowburper	noburpers
nowdays	nowadays
nowehere	nowhere
nowww	now
noy	not
noyawn	yawn
npas	pas
npd	nod
npi	ni
npr	nor
nps	ups
npthing	nothing
nqp	nap
nr	no
ns	is
nsaid	said
nsaids	said
nsfw	now
nsh	ash
nsha	she
nsker	asker
nsket	asked
nsla	nola
nsvt	not
nsw	now
nt	it
ntame	name
ntanyl	tanya
nten	ten
ntgen	then
nthe	the
ntomas	tomas
nts	its
nuestra	cuesta
nuestro	maestro
nuevo	nero
nuffield	outfield
nuit	quit
nul	nut
numbess	numbers
numer	number
numero	number
nunca	bunch
nur	our
nurp	burp
nuss	nuts
nutella	stella
nuthin	nothing
nutri	nutria
nutrl	until
nutropath	naturopath
nutso	nuts
nutz	nuts
nuva	nova
nuvaring	nearing
nux	nut
nv	no
nvisa	visa
nvisade	visage
nvm	nam
nvrm	norm
nw	no
nx	no
ny	my
nyc	nyx
nye	eye
nyp	nap
nyt	not
nz	no
nzd	nod
nzers	needs
o'dell	odell
o'hare	o'hara
oa	a
oaah	oath
oap	map
oaty	oath
obe	be
obecnie	beanie
obgyn	obey
obispo	obis
oblig	oblige
obrigada	brigade
obrigado	brigade
obs	jobs
observando	observant
obsese	obsess
obsesively	obsessively
obstante	obstacle
obstinated	obstinate
obtenir	oftener
obtuve	obtuse
obudsman	ombudsman
obv	ob
obvi	obi
obvio	obvious
obvisouly	obviously
obvs	ob's
obvservation	observation
ocasionally	occasionally
ocasions	occasions
ocassional	occasional
ocassionally	occasionally
ocassions	occasions
occaionally	occasionally
occaison	occasion
occaisonally	occasionally
occam's	ocean's
occams	occam
occasians	occasions
occasionaly	occasionally
occasione	occasion
occassion	occasion
occassional	occasional
occassionally	occasionally
occassionaly	occasionally
occassions	occasions
occurance	occurrence
occure	occur
occured	occurred
occurence	occurrence
occurences	occurrences
occuring	occurring
ocd	old
oceana	ocean
ocho	echo
ocks	rocks
ocotber	october
octopussy	octopus
ocurre	course
ocurred	occurred
ocurrence	occurrence
odansetron	ondansetron
oderless	odorless
odio	odin
odour	odor
odourless	odorless
odt	out
oei	oi
oeople	people
oes	does
oesophagal	esophageal
oesophage	esophagi
oesophageal	esophageal
oesophagitis	esophagitis
oesophagitus	esophagitis
oesophagous	esophagus
oesophagus	esophagus
oesophagy	esophagi
oesophegeal	esophageal
oesophegus	esophagus
oesophogus	esophagus
oesophpgus	esophagus
oesophugus	esophagus
oesphageal	esophageal
oespphagus	esophagus
ofan	fan
ofc	of
ofcourse	course
ofdf	off
off's	offs
offence	offense
offfice	office
offguard	outguard
offputting	offsetting
offsite	offside
ofr	of
ofte	often
ofzo	ouzo
og	of
ogd	old
ogestrel	kestrel
ogilvie	gillie
ogs	dogs
ogy	orgy
ohare	share
oher	her
ohh	oh
ohhh	oh
ohip	ship
ohmy	ohm
ohne	one
ohp	oh
ohren	oren
ohsu	ohs
ohsu's	ohsa's
oikos	oiks
oinky	kinky
ois	is
oit	it
oj	of
ojal	oral
ojala	oral
okanagan	flanagan
okane	kane
okayish	grayish
okayyy	okay
okc	ok
okee	oke
okey	okay
okish	kish
okk	ok
okkk	okay
okok	kook
okolic	frolic
oktober	october
oky	okay
ol	of
olan	plan
olarinde	larine
olds	old
oldum	oleum
ole	one
olha	olga
oligo	olio
olipops	lollipops
olk	old
ollerton	fullerton
olly	only
olly's	molly's
olol	all
oloriz	gloria
olsun	olsen
oltre	older
oluyor	fluor
oma	ma
omdat	meat
ome	me
omeoprazol	omeprazole
omeoprazole	omeprazole
omep	omen
omeperozole	omeprazole
omeperzole	omeprazole
omeprazol	omeprazole
omeprazole's	omeprazole
omeprazoles	omeprazole
omeprezale	omeprazole
omeprezol	omeprazole
omeprezole	omeprazole
omeprizole	omeprazole
omeprozale	omeprazole
omeprozol	omeprazole
omeprozole	omeprazole
omf	of
omfg	of
omg	om
omggg	omega
omgosh	gosh
omgyes	orgies
omigosh	amigos
omland	land
omnejd	owned
omoperazole	omeprazole
omoprazole	omeprazole
ompeprazole	omeprazole
omperazole	omeprazole
omperezole	omeprazole
omperozole	omeprazole
omprazole	omeprazole
ompreprazole	omeprazole
omst	most
omv	om
omw	ow
onady	only
onady's	lady's
onboard	inboard
ond	and
onda	honda
ondanks	fondants
ondare	dare
onder	under
ondering	wondering
onece	once
oneday	someday
oniony	onion
ons	on
onsent	consent
onsite	onside
ontarians	ontarian
onther	other
ontop	onto
ony	on
onyl	only
onyour	your
ooc	ooh
ooft	soft
oohhh	ooh
ooit	omit
ook	look
oolong	oblong
oompa	oomph
oon	on
oong	long
ooo	too
ooof	roof
oooh	ooh
ooohh	ooh
oookay	okay
oooo	good
oooof	proof
ooooh	ooh
ooooo	voodoo
oooor	door
ooops	hoops
ooopsie	footsie
oop	top
oopmax	lomax
oopmh	oomph
opathe	spathe
opec	open
opeing	opening
openin	opening
operacj	operate
operado	operate
operafion	operation
operar	opera
operasjon	operation
operatering	operating
operatie	operate
operationen	operation
operazione	operation
operston	person
opgeven	pleven
opini	opine
opinoin	opinion
opiods	options
opioids	opioid
opleiden	leiden
oplevet	olivet
opmaken	oaken
opnemen	linemen
opp	pop
oppening	opening
oppies	poppies
oppointment	appointment
opprotunity	opportunity
oprazole	pyrazole
oprecht	brecht
oprette	pretty
opslag	slag
optimises	optimists
optimiste	optimist
optum	opium
oracoat	peacoat
orale	oral
oramai	drama
orc	or
ord	or
orde	order
orden	order
orderes	orders
ordnet	order
organisation	organization
organisations	organizations
organise	organize
organised	organized
organiser	organizer
organising	organizing
orhers	others
originaire	originate
orinal	urinal
orior	prior
orl	or
orlov	orlon
orlov's	orlon's
ormond	hormone
oro	or
orofacial	orificial
orogastric	orgastic
oroginates	originates
orourke	o'rourke
orrr	orr
orrrrr	orrery
ors	or
ortho	orth
orthognathic	orthographic
orthotropics	orthotropic
orton	orion
osa	asa
oschner	escher
osciller	schiller
oscopy	copy
osmolax	smilax
osophageal	esophageal
osophagus	esophagus
osophegus	esophagus
oss	ass
osteo	step
osteoperosis	osteoporosis
osu	sou
osv	os
ot	to
otalaryngologist	otolaryngologist
otavio	octavio
otc	oct
otehr	other
othe	the
other's	others
otherside	otherwise
otherwords	motherworts
otl	oil
oto	to
otoh	ooh
otolaryngolists	otolaryngologists
otorrino	torino
otra	ora
otras	okras
otro	otto
otros	ours
ots	its
otw	tow
ou	you
ouais	ours
oude	dude
ouhhh	ought
oura	our
ouside	outside
outa	out
outake	outage
outburp	outburst
outcold	outsold
outhere	there
outliner	outline
outloud	outlook
outpaient	outpatient
outro	outdo
outros	ours
outrule	outrun
outtings	outings
outttt	outta
outwide	outside
ouvert	overt
ovan	van
ovbiously	obviously
ove	one
overal	overall
overblow	overflow
overblowing	overflowing
overdag	overdo
overdrank	overran
overdrinking	overprinting
overeactive	overactive
overed	covered
overewhelming	overwhelming
overextension	overexpansion
overfaced	overrated
overgaan	overran
overgroeth	overgrowth
overgrowths	overgrowth
overhungry	overhung
overlake	overtake
overnatte	overstate
overprescribed	overprescribe
overrelying	overruling
overshare	oversharp
oversharer	oversharp
oversharing	overhearing
oversised	oversized
overthink	overshine
overthought	overwrought
overtight	overnight
overtreated	overrated
overtube	overture
overwegen	overseen
overwith	overwrite
ovi	oi
ovol	oval
ovom	ovum
owever	however
oww	own
owwww	powwow
owyn	own
oxazepam	diazepam
oxgen	oxygen
oximeter	odometer
oximiter	limiter
oxylates	oxalates
oy	of
ozempic	olympic
ozlem	oiled
ozole	ozone
paas	pass
pac	pay
pacientes	patients
pacs	pass
pacu	pack
padawan	palawan
padi	paid
paediatric	pediatric
paediatrician	pediatrician
paediatrics	pediatrics
pagina	vagina
paina	pain
painfull	painful
painnn	pain
paintless	pointless
paio	paid
pais	paid
pakenham	dagenham
palafer	palaver
palerino	palomino
paletable	palatable
palicki	panicky
pallate	palate
palo	palm
paloma	palma
palori	pylori
palpatations	palpitations
palpations	palpation
palpiutations	palpitations
palps	pals
panadol	paradox
pancit	pandit
pandamic	pandemic
panella	paella
panera	paper
panicc	panic
paniced	panicked
panick	panic
panicker	panicked
panini's	pain's
paolo	polo
papilations	populations
pappermint	peppermint
paralelo	parallel
paralised	paradise
paralized	paralyzed
parall	parole
paralyse	paralyze
paralysed	paralyzed
paralysing	paralyzing
parasympathietic	parasympathetic
parce	pace
parceque	barbeque
parcial	partial
parcours	parlors
parec	pare
parece	pareve
parecer	prefer
pareil	parent
paresthetica	parenthetic
parfois	paris
pargona	pardon
paricularly	particularly
paristalsis	peristalsis
parkside	parasite
parlare	palace
parle	parole
parlent	parent
parler	parlor
parlo	parlor
parlour	parlor
parm	part
parmesean	parmesan
parmi	parma
paro	part
parosmia	anosmia
partager	partaker
parte	part
parter	partner
parters	partners
partes	parts
parti	part
particularily	particularly
partie	parties
partum	part
partys	party
partyyy	party
pasa	past
pasaba	casaba
pasado	parade
pasar	paar
paso	past
passait	passant
passe	pass
passements	basements
passent	assent
passera	passer
passified	classified
passout	passport
passt	past
pastillas	pastilles
pastina	pasting
patato	potato
patern	pattern
patho	path
pathologie	pathologies
pathologize	pathologist
pati	path
patioend	patient
patolog	catalog
patricks	patrick
patronised	patronized
patronising	patronizing
paule	pale
paulo	paul
paus	pass
pavesi	paves
pavia	pavid
paxil	pail
payla	paula
pazienti	patient
pbs	pas
pca	pa
pcd	pod
pcm	pam
pcos	cos
pcpd	pcp
pcps	pops
pcq	pc
pcs	pas
pct	put
pda	pad
pdawes	dawes
pdfs	pd's
pds	ads
pdx	pox
peaced	peace
peasy	easy
peau	peak
pebbels	pebbles
pebzin	perrin
pecho	echo
pectus	rectus
ped	red
pedi	jedi
pediatr	pediatric
peds	feds
peesy	pees
pegnant	pregnant
peilig	ceiling
peine	pine
peleton	peloton
pelivc	pelvic
pelosi	pesos
penaut	peanut
pencher	puncher
pendiente	pendent
pene	pen
penge	pence
pensais	penis
pense	sense
pensei	sense
penser	denser
pensez	sense
peobably	probably
peoceed	proceed
peopel	people
peopl	people
peor	poor
peores	pores
pepcids	pepcid
peple	people
pepogest	peppiest
pepperidge	peppering
pepsid	pepsi
pepsins	pepsi's
peptac	peptic
peptalks	peptalk
pepto	pesto
peque	pique
pequods	periods
percenters	presenters
perculating	percolating
perculiar	peculiar
perd	per
perdere	perdure
perdue	perdu
perf	per
perfekt	perfect
perferated	perforated
perfetto	perfecto
perfil	peril
performaning	performing
performatively	performative
perhapd	perhaps
periode	period
periodo	period
periodontitis	periodontics
peristalisis	peristalsis
peritonite	peritonitis
perma	perm
permament	permanent
permamently	permanently
permanente	permanent
permeant	percent
perminate	terminate
pernament	permanent
pero	per
peroni	peron
peroral	personal
perpetuum	perpetual
perphaps	perhaps
perplejo	perplex
perplexe	perplexed
perscibed	prescribed
perscribed	prescribed
perseverating	persevering
persistalisis	peristalsis
persistant	persistent
persiste	persist
personeel	personnel
personel	personal
personnal	personal
personnally	personally
personne	personnel
personnes	personnel
perstalsis	peristalsis
persue	pursue
persuing	pursuing
pesadas	pesetas
pesanti	peasant
pessoal	personal
petav	petal
petechiae	petechia
petits	petit
petrolium	petroleum
peu	per
peur	per
peut	put
peux	put
pewno	piano
pf	of
pfd	pod
pfew	few
pfff	puff
pffft	puff
pft	put
pften	often
pga	ga
pgad	pad
pgh	ugh
phagophobia	photophobia
pharengeal	pharyngeal
pharengyal	pharyngeal
pharma	dharma
pharmacutical	pharmaceutical
pharyngeus	pharynges
phds	pods
phelgm	phlegm
phelgms	phlegm
phelm	helm
phenomemon	phenomenon
phila	phil
philidelphia	philadelphia
phisical	physical
phisician	physician
phisiological	physiological
phlebotomist	phlebotomies
phleghm	phlegm
phleghmy	phlegmy
phlegms	phlegm
phlem	phlegm
phleming	fleming
phlemmy	phlegmy
phlemy	phlegmy
phmetry	poetry
pho	who
phonecall	phonecard
phoniatric	podiatric
php	pop
phsyio	physio
phychiatrist	psychiatrist
phycological	psychological
phycologist	psychologist
physcailly	physically
physcotherapy	physiotherapy
physially	physically
physicaly	physical
physio's	physic's
physiotehrapy	physiotherapy
phytic	physic
pibb	bibb
pickes	picked
pida	vida
pidiendo	pimiento
pieds	pies
pieni	piece
pienso	piano
pierdas	pierces
pierdes	pierces
pierogies	pirogi's
pierogis	pirogi
pieter	peter
pii	pig
pijn	pin
pilaris	polaris
pillcam	pillar
piller	killer
pillori	pillory
pilori	pylori
pils	piss
pinchar	pincher
pinchy	pinch
pineville	neville
piontless	pointless
piquer	piqued
piqure	pique
pital	vital
pitao	pita
pitma	pita
pitman's	pitmans
pitmann	pitman
pittmans	pitmans
pitty	pity
pixcin	pixie
pizanos	pianos
pj	pa
pjc	pic
pjs	pas
pla	play
plads	plans
plaisir	plainer
planful	playful
planifier	pacifier
plannable	plantable
plannen	planned
plateaud	plateau
plateued	plateaued
platued	plagued
playdates	playmates
playlist	playlet
playlists	playlets
pleague	league
pleaseee	please
pleasent	pleasant
pleasently	pleasantly
pleaser	please
pleghmy	phlegmy
plegm	phlegm
plek	plea
ples	plus
plesant	pleasant
plesss	please
pllc	all
pls	plus
plse	else
plsss	less
plssss	passes
pluracy	piracy
plushie	plushier
plut	put
plyori	pylori
plz	ply
pmc	pic
pmcid	paid
pmdd	paid
pmed	peed
pmi	mi
pmid	paid
pming	ping
pmo	pro
pms	pas
pmsing	posing
pmuch	much
pn	in
pnd	and
pner	per
pneumo	pneuma
pnw	paw
pochino	poaching
pockests	pockets
pocos	poco
pocus	focus
podcasts	podcast
podemos	poems
poder	power
poderia	peoria
podido	podium
podr	poor
poeple	people
poibt	point
poisined	poisoned
poisonong	poisoning
poissoning	poisoning
pok	pop
pokibgy	poking
pokings	poking
polak	polar
polll	polls
pollo	polls
polos	polls
polski	polka
polycystic	polycyclic
polyol	pool
polyols	polls
pomoglo	pomelo
pondre	ponder
pondu	pond
poner	power
ponerme	phoneme
ponga	pong
pongo	pong
poniewa	ponies
ponse	pose
ponsonby	pozsony
pontentially	potentially
ponv	pony
pooffs	poofs
pooofs	proofs
pooper	proper
poopie	potpie
poopy	poop
pooted	posted
pop''s	pope's
poppi	poppy
poppis	poppies
poprocks	pollocks
popsicles	popsicle
poptarts	poplars
poquito	coquito
por	for
porfa	port
porque	torque
porta	port
portaloo	portal
portillo	tortilla
portillo's	portico's
portillos	tortillas
portlanders	portlander
porto	port
pos	pop
posibble	possible
posible	possible
positieve	positive
positif	position
positifs	position
positiv	positive
positon	position
positve	positive
poss	pass
possbilities	possibilities
possble	possible
possibile	possible
possibilit	possibility
possibilty	possibility
possibily	possibly
possiblities	possibilities
possiblt	possible
possiboy	possibly
posso	posse
postar	poster
postdosing	postponing
poste	post
postet	posted
postive	positive
posto	post
postop	post-op
potantiel	potential
potatos	potato
poteau	potent
potentialy	potential
potox	botox
potresti	poorest
potsies	posies
poucos	pounds
pourra	pour
pourrai	courtrai
pourrait	portrait
pouvais	louvain
pouvait	louvain
pouvez	poured
pouvoir	boudoir
pov	pop
powerade	powered
powerfull	powerful
pp	up
ppd	pod
ppe's	pope's
ppen	open
ppenv	open
ppi's	cpi's
ppis	pips
ppl	pal
ppl's	pal's
pple	pile
ppos	pops
ppp	pop
pps	pops
ppte	pete
pq	pa
pra	pray
praatte	prattle
practicians	practicing
practicioner	practitioner
practictionners	practitioners
practing	prating
practinh	practice
practioner	practitioner
practique	pratique
prakash	rakish
pral	pray
pratar	prater
pratice	practice
pratiquent	pratique
pratiquer	pratique
pratiques	pratique
prayin	praying
prayy	pray
prazole	pyrazole
prcoedure	procedure
preapproval	preapprove
preassure	pressure
preattached	reattached
prebiotic	probiotic
prebiotics	probiotic
prebotox	prebook
preburp	rebury
preceeding	proceeding
precent	present
precident	president
precies	precise
precis	precise
precordial	primordial
precription	prescription
predictible	predictable
predispositioned	predisposition
predominently	predominantly
prefent	present
prefered	preferred
preferenza	preference
preferrably	preferably
preformerd	preformed
preg	prep
pregamed	pregame
pregaming	preparing
pregant	pregnant
preggars	beggars
preggers	prefers
preggo	peggy
preggy	peggy
prego	press
pregunt	present
prelim	prelims
prem	prom
premanent	permanent
premara	prepare
premera	prefer
premi	premie
prend	trend
prendra	brenda
prendre	prepare
prends	trends
preneuse	pretense
preoccupa	preoccupy
preocupa	preoccupy
preocupacion	preoccupation
preocupe	procure
preop	prep
preopen	reopen
preping	prepping
prepre	prepare
prescribers	prescribes
prescriped	prescribed
prescryption	prescription
presi	press
presiure	pressure
preso	press
presque	pressure
pression	impression
presssure	pressure
pressups	pressure
pressurise	pressurize
pressurised	pressurized
pressurises	pressurizes
prestado	presto
prestar	restart
prestations	presentations
presumedly	presumably
presumingly	presuming
presure	pressure
preto	presto
prettt	pretty
prevacid	prevail
prevelance	freelance
prevelant	prevent
preventatable	preventable
preventatively	preventative
preventively	preventive
previo	previn
pricedure	procedure
pricings	pricing
prie	price
prik	prick
prilozec	prilosec
prima	prime
primark	primary
primeiros	primers
primeras	primers
primeros	primers
principio	principal
prioritise	priorities
prioritised	prioritized
prioritising	prioritizing
pris	pros
prise	price
prisolec	prisoner
pristiq	pristine
prit	print
priv	privy
privat	private
privatised	privatized
privato	private
priveleges	privileges
privledge	privilege
prn	pin
prob	rob
probabaly	probably
probablly	probably
probablyyy	probably
probado	probate
probando	roband
probanly	probably
probar	proper
probeer	problem
proberen	properer
probiotcs	probiotic
probiotics	probiotic
probiotoc	probiotic
probl	probe
probleem	problem
problema	problem
problemas	problems
problematik	problematic
probleme	problem
problemen	problem
problemer	problem
problemet	problem
problemi	problem
problemm	problem
problemo	problem
problemos	problems
problemstic	problematic
probly	probably
probs	probe
proc	pro
proccesed	proceed
proccess	process
procecedure	procedure
procecudre	procedure
procedere	procedure
procedue	procedure
procedura	procedure
proceduren	procedure
proceedure	procedure
proceedures	procedures
proces	process
processen	processed
processus	processes
prochaine	procaine
prochains	proclaims
procsdure	procedure
procude	procure
procudes	procures
procudre	procure
procudure	procedure
procur	procure
procurando	procurance
procurem	procure
procuuedure	procedure
prodecure	procedure
prodedure	procedure
producci	produce
producen	produce
producir	producer
productos	products
produzca	produce
produzco	produce
profesional	professional
profesionales	professionals
professionnals	professionals
proffesional	professional
proffesionals	professionals
proffessor	professor
progess	process
programada	programed
programme	programmed
progresser	progressed
progressivily	progressively
progresso	progress
projectiled	projectile
projectory	projector
proliance	province
prolly	polly
prolongued	prolonged
pronbably	probably
prononc	pronounce
propably	probably
properlly	properly
propertly	property
propio	proper
proplem	problem
proplems	problems
propmt	prompt
propofol	proposal
propos	propose
propper	proper
prosecco	prosector
proteine	protein
protien	protein
protip	profit
protnix	protein
proto	photo
protonics	protonic
protonix	protonic
prova	prove
provoc	provo
provocar	provoker
provokated	provoked
provoquer	provoker
proximit	proximity
prozedur	procedure
prozess	process
prozesses	processes
prs	pro
prueba	rumba
pruebas	pebas
pschological	psychological
pshhh	psych
psicol	pistol
psoriatic	psoriasis
pss	ass
psss	pass
pssss	pass
psvt	psst
psychologic	psychological
psychologized	psychologize
psychoterapy	psychotherapy
psylium	asylum
psyllium	pallium
pto	to
pts	its
ptsd	its
pubblication	publication
pubertad	pubertal
publi	public
publically	publicly
publicar	publican
publice	public
publicising	publicizing
publie	public
publix	public
publlic	public
pubmeb	pubes
pubmed	pulled
puckup	pickup
puddingy	pudding
pude	pure
pudendal	pudenda
pudo	judo
pueda	plead
puede	suede
pueden	queen
puedes	pieces
puedo	undo
puerto	puberty
pues	puts
puffyness	puffiness
puha	puma
puis	puts
puisse	cuisse
pukiness	pokiness
puky	puke
pulgrimage	pilgrimage
pullin	pulling
pulmatory	pulsatory
pulmory	pulmonary
pummm	pump
punkt	punk
puno	punk
puntapi	punjabi
punto	unto
puoi	poi
pur	our
pura	pure
purp	pure
purre	pure
pursiining	purloining
pusging	pushing
pushback	bushbuck
pusieron	positron
pusinhg	using
puso	push
pussied	pussies
putney	puny
putten	putter
pv	pa
pvcs	pics
pyjama	pajama
pyloris	pyloric
pylory	pylori
pyroli	parole
pyschologist	psychologist
q's	e's
qc	ac
qere	were
qg	ag
ql	al
qld	old
qns	ins
qol	sol
qph	ph
qr	or
qs	is
qtips	tips
qu	u
qu'elle	quell
qu'il	quail
qu'ils	quails
qu'on	upon
qu'une	queue
qual	equal
qualche	quiche
qualit	quality
qualsiasi	quassias
qualtrics	quadrics
quand	quad
quando	quango
quanto	quant
quarantin	quarantine
quase	quake
queazy	queasy
quebecois	québecois
qued	que
queerie	queer
quelle	quell
quelque	queue
quelques	queues
quels	fuels
quem	que
quences	quenches
quents	quests
quer	que
querey	query
queria	query
ques	que
quesadillas	quesadilla
quesitons	questions
queso	quest
quess	guess
questa	quest
questionaire	questionnaire
questionare	questionary
questo	quest
quesy	quest
qui	quit
quicks	quick
quicky	quick
quidos	quid's
quiely	quietly
quien	quiet
quiera	quiet
quiere	quire
quieres	quires
quiero	quiet
quil	quit
quils	quits
quina	quinn
quindi	quid
quinoa	quinol
quinta	quint
quipe	quite
quiser	quiver
quitetly	quietly
quiting	quitting
quo	que
quora	quota
quotidiani	quotidian
quradratus	quadrates
qustions	questions
qvar	var
qw	ow
qwqy	why
qz	oz
raad	read
raar	rear
rablement	rabblement
rachen	rachel
raconter	raconteur
rad	had
radicalement	radioelement
radiolab	radioman
raffery	rafters
rafii	radii
raftery	rafters
ragdoll	randall
ragey	rage
ragland	raglan
ragona	ramona
ragrets	regrets
rahe	race
rahnoodle	canoodle
raimundo	raymundo
rainn	rain
rainspout	rainout
raison	raisin
raisons	raisins
ral	real
ralement	basement
raliste	raise
ralistes	raises
raluca	alula
raman	roman
rambley	ramble
rambly	ramble
ramping	camping
ramq	ram
rando	random
randomely	randomly
randomisation	randomization
randomise	randomize
randomply	randomly
rapa	rape
rapar	radar
rapene	rapine
raphe	rape
rapide	rapid
rappelant	appellant
rappelez	rappel
raras	arras
rarement	basement
raro	rare
rassure	assure
ratemd	rated
raten	eaten
ratnaker	rainmaker
ratoires	retires
rattely	rattly
raus	rats
ravale	ravage
ravaler	ravager
ravich	ravish
ravitch	ravish
rawdog	random
rawr	raw
rayed	raped
raynaud	reynaud
raynauds	reynards
raz	ran
razne	raze
rbe	be
rc	re
rcbpd	rcpd
rccp	rcp
rcd	red
rcdp	rcp
rcfd	rcpd
rcod	rod
rcpc	rcp
rcpcd	rcpd
rcpd's	road's
rcpders	readers
rcpdrs	rapers
rcpds	rcpd
rcpg	rcp
rcps	rips
rcpsld	rcpd
rcpt	rapt
rct	act
rcts	acts
rdas	rads
rdc	roc
rdcentral	central
rdelig	relic
rden	den
rdige	ridge
rdls	roll
rdpd	rcpd
rds	ads
rdv	rev
rdy	dry
rea	real
reaaally	really
reacci	reach
reactie	reactive
reagi	ragi
reaktion	reaction
realated	related
realaxing	relaxing
realease	release
realidad	realized
realisation	realization
realisations	realizations
realise	realize
realised	realized
realises	realizes
realising	realizing
realisty	reality
realitively	relatively
realiz	realize
reall	really
reallh	really
reallizing	realizing
realllly	really
reallly	really
realllyy	really
realls	really
reallyyy	really
realt	real
realtime	mealtime
realy	really
reas	real
reasearch	research
reasonings	reasoning
reasuring	measuring
reasuringly	reassuringly
reasurring	measuring
reaults	results
reavted	reacted
rebalance	rebalanced
rebalancing	balancing
rebbl	rebel
rebooked	rebooted
rebooking	rebooting
rebranded	branded
rec	red
recalcar	calcar
reccomend	recommend
reccomendation	recommendation
reccomendations	recommendations
reccomended	recommended
reccomending	recommending
reccomends	recommends
reccommend	recommend
reccommended	recommended
reccommends	recommends
receeded	receded
receiption	reception
receptinist	receptionist
recevoir	reservoir
rech	reach
recherches	recherché
reching	reaching
recib	recipe
recient	recent
recieve	receive
recieved	received
recieverd	received
recieving	receiving
recimi	recipe
recind	remind
recipy	recipe
recognisable	recognizable
recognise	recognize
recognised	recognized
recognises	recognizes
recognising	recognizing
recoknised	recognized
recomemmend	recommend
recomend	recommend
recomending	recommending
recomiendo	recommend
recommande	recommend
recommanded	recommended
recommencer	recommence
recommendeds	recommended
recommender	recommended
recommeneing	recommending
recommmend	recommend
recongizes	recognizes
recreationally	recreational
recs	revs
recuerde	recede
recul	recut
recuperaci	recuperate
recuperado	recuperate
recurso	recurs
redbubble	redouble
redbull	redbud
reddit	geddit
reddit's	eddie's
reddita	reddish
redditer	redder
redditers	reciters
redditing	reediting
redditor	editor
redditors	editors
reddits	reedits
redditt	reddish
redditu	reddish
reddt	redd
reder	refer
redhced	reduced
rediculous	ridiculous
redigesting	predigesting
redirig	retiring
redistrbiutes	redistributes
redit	credit
reditter	remitter
redittor	editor
redjeep	redeem
redlight	relight
redlux	reflux
redose	repose
redrum	drum
reducir	reducer
reduje	reduce
reduzco	reduce
redwan	redan
reeaally	really
reeeally	really
reenforcement	reinforcement
refaat	repeat
refaire	refire
refax	relax
refeeding	reseeding
refelx	reflex
referais	refrain
referal	referral
referall	referral
refered	referred
refering	referring
refferal	referral
reffered	offered
refieres	refers
reflax	relax
reflejo	reflect
reflix	reflex
reflujo	reflux
reflujos	refluxes
refluxate	reflate
refluxe	reflux
refluxer	refluxed
refluxers	refluxes
refluxy	reflux
refluz	reflux
reframe	frame
reframed	framed
refried	retried
refux	reflux
regarde	regard
regarder	regarded
regels	rebels
regence	regency
regi	reg
regionals	regional
regiong	region
reglan	raglan
reglate	relate
regner	regret
regnosing	regrowing
regrette	regretted
regs	legs
reguarding	regarding
reguarly	regularly
regulalrly	regularly
regulard	regular
regulary	regular
reguraly	regularly
reguration	regulation
regurg	return
regurgation	regulation
regurge	regorge
regurgigation	regurgitation
regurgitaion	regurgitation
regurgitatation	regurgitation
regurgitations	regurgitation
regurgitative	regurgitate
regurgitator	regurgitate
regurgition	regurgitation
regurguation	regurgitation
reguritated	regurgitated
reguritation	regurgitation
regurtitation	regurgitation
rehydration	dehydration
rei	red
reiki	reign
reinejction	reinjection
reinject	reinfect
reinjected	reinfected
reinjections	reinfections
reise	raise
rejuver	recover
rekening	evening
rekt	rest
relacion	relation
relacionalo	relational
relajar	relaxer
relarn	relearn
relatability	reliability
relateable	relatable
relationshhip	relationship
relativ	relative
relativly	relatively
relato	relate
relaxe	relax
relaxen	relaxed
relaxin	relaxing
relaxine	relaxing
relaxt	relax
releaae	release
releaf	release
releasee	release
releashed	released
releass	release
releave	release
releaving	releasing
releif	relief
releive	receive
releived	received
releives	receives
releiving	receiving
reletively	relatively
relev	rule
relevent	relevant
relevie	release
relfex	reflex
relflux	reflux
relfux	reflux
relgan	reagan
reliefed	relieved
reliefing	relieving
reliev	relief
relievedc	relieved
relif	relief
relise	relive
relly	really
relse	else
relutant	reluctant
relux	relax
rem	red
remarqu	remarque
rember	member
rembours	tambours
remeber	remember
remediate	immediate
remediations	remediation
rement	recent
remercie	reverie
remeron	cameron
remindme	remind
remisser	register
remited	recited
remitterad	remitted
remmeber	remember
remont	fremont
rence	fence
rencontr	rencounter
rencontrer	rencounter
rendez	render
rendu	rend
renifler	jenifer
rennie's	ronnie's
rennies	pennies
renny	penny
reoccurance	reoccurrence
reorganise	reorganize
reorganised	reorganized
reoxygenating	oxygenating
repas	repay
repeate	repeat
reperition	repetition
repersentation	representation
repetoir	repertoire
repidly	rapidly
repollo	apollo
reponds	responds
reponse	response
repopulation	depopulation
repos	reps
repost	report
reposted	reported
reposting	reporting
repsonse	response
reptar	repeat
repurposing	purposing
reputated	repeated
req	red
reqlly	really
reqs	revs
requ	real
requestion	question
rer	her
reras	rears
res	rest
reseach	research
researchs	research
resensitize	desensitize
resensitized	desensitized
resharing	reshaping
reshmi	resume
resized	resided
resizes	resides
resolva	resolve
resp	rest
respecto	respect
respiracion	respiration
respiratori	respiratory
respirer	respire
responce	response
responderles	responders
responible	responsible
responsabilit	responsibility
responsability	responsibility
resposting	reporting
ressant	resent
resse	reese
ressemble	resemble
ressens	lessens
ressources	resources
resssuring	reassuring
restabilize	destabilize
restait	restart
restaurantes	restaurants
reste	rest
restera	rester
restylane	restyle
resub	rest
resultaat	resultant
resultado	resulted
resultados	resultants
resultat	resultant
resultaten	resultant
resum	resume
resus	jesus
ret	get
retchin	retching
reticuli	reticule
retighten	tighten
retightens	tightens
retning	renting
retorno	return
retour	detour
retourn	return
retours	detours
retreatment	pretreatment
retrograd	retrograde
retrouver	retriever
retruning	returning
retweeted	retreated
reupload	upload
revelationary	revolutionary
revenu	revenue
revenus	revenue
reverp	revert
reverps	reverts
reversable	reversible
revienne	revenge
revient	recent
revisara	revisal
revulsed	repulsed
rewatch	rematch
rewatching	rematching
rex's	ex's
rext	next
reynaulds	reynolds
reza	rena
rg	re
rgb	rob
rgd	red
rgo	go
rgsm	room
rhabdo	abdo
rhcp	rcp
rhe	the
rheten	rotten
rhys	rays
ri	i
ribbets	gibbets
ribcages	ribcage
ribeir	river
ribena	ribera
ricard	richard
riche	rich
richiede	richie
richting	righting
ricola	nicola
ricordo	ricardo
riddiculous	ridiculous
rideshare	timeshare
ridiculus	ridiculous
riduculous	ridiculous
rie	die
rien	risen
rience	since
riesgo	diego
riesige	resign
rif	if
rifaxin	ritalin
rifht	right
rifier	rifer
rifr	rift
rigby	rugby
righht	right
rightous	righteous
rightt	right
rigourously	rigorously
rigth	right
rigtig	rigid
rigtige	ragtime
riiight	right
rince	since
ringfit	ringgit
ripp	rip
rir	air
risico	rising
risico's	rico's
risker	risked
risolto	risotto
rispondi	respond
risque	bisque
ritchie	richie
ritiual	ritual
rivalus	rivals
riz	rid
rj	re
rjade	jade
rjan	ran
rjat	rat
rka	aka
rke	re
rkelige	relive
rl	re
rld	old
rlich	rich
rlly	rely
rls	els
rly	fly
rmb	rob
rmemeber	remember
rmst	rest
rmt	rat
rna	ran
rnoburp	noburp
rns	runs
rny	any
ro	to
roadmap	roadway
roadtrip	roundtrip
roary	roar
robax	road
robbi	rabbi
robitussen	robitussin
rodel	model
rodillas	gorillas
roesje	rose
rof	of
rohlfing	rolling
rolaid	roland
rollen	rolled
rollerbladed	rollerblade
rollercoasters	rollercoaster
rollup	roll
rolo	roll
ronn	ron
ronnybrook	donnybrook
rons	runs
roomate	roommate
roomie	rookie
roomies	rookies
rootbeer	rooter
ror	for
ros	cos
rosacea	rosales
roselare	rosemary
rosen	rose
rosow	resow
rossow	crossbow
rotais	rota's
roter	roger
rotez	rote
roti	rot
rotman	roman
roto	root
rougly	roughly
rouke	route
roule	rule
rousse	rouse
rozwa	row
rpa	rap
rpcd	rcpd
rpd	red
rpg	rig
rps	ups
rre	are
rreleasing	releasing
rrez	are
rri	sri
rrightward	rightward
rrribbit	ribbit
rrsp	rasp
rsbrok	rebook
rselo	sell
rsnj	run
rspd	rcpd
rst	rest
rsta	rita
rste	rate
rstod	stop
rsv	rev
rt	it
rta	rat
rth	ruth
rto	to
rucker	sucker
ructer	ruyter
rufkm	rum
ruhe	rule
ruiner	ruined
rull	full
rulloa	sulla
rumblier	crumblier
rumblies	rumbles
rummbles	rumbles
rumour	rumor
rund	run
runnning	running
runnnnn	running
ruq	run
rusa	rush
rutto	putto
ruysdale	ruysdael
ruysdeal	ruysdael
rvps	rips
rw	re
rway	way
rwc	roc
rzte	rate
rztin	ruin
rzuci	ruck
rzy	ray
s'agit	seagirt
s'am	slam
s'assurer	assurer
s'est	best
s'il	sail
s'int	saint
sa	a
saaaame	salaam
saame	same
sabe	same
sacaba	scuba
sacarme	scare
sache	ache
sadely	safely
sadman	madman
sagde	sage
sagr	sage
sagt	sat
sagte	sage
sahals	shall
saillight	taillight
sainsbury's	salisbury's
sais	said
sait	said
salamu	salami
salavating	salivating
salavation	salvation
salga	salsa
sali	sail
salido	salado
salir	salic
salivait	saliva
salive	alive
salivia	saliva
sallad	salad
sallivating	salivating
sallowing	allowing
salomon	salmon
saltburn	saturn
salud	salad
saludo	salado
saludos	salads
salut	salt
salva	saliva
salvitation	salvation
samarin	samaria
samee	same
sameee	same
sameer	ameer
samesies	safeties
samia	samba
samma	gamma
samme	same
sammog	summon
samsies	samples
samw	same
sandet	sander
sandhu	sadhu
sandifer	sandier
sandwhich	sandwich
sani	sand
sanjay	sanjak
sant	want
sant'anna	santana
santa's	manta's
santi	santa
santosh	santos
saometimes	sometimes
sapho	sappho
sapiens	sapient
sar	say
sarcasic	sarcastic
sarebbe	saree
sarei	sari
sarno	arno
sarted	started
sas	was
sashimi	dashiki
saskie	sake
satisying	satisfying
sativa	saliva
sativas	natives
sato	sat
satx	sat
saucey	sauce
saud	said
sauf	saul
saura	aura
saut	shut
sauter	saucer
sav	say
savez	save
savinga	saving
savoir	savior
savour	savor
sawllow	swallow
sayd	say
sayin	saying
sayyy	say
saznao	sauna
sbds	sods
sbft	soft
sbout	about
scalenes	scalene
scammers	stammers
scarey	scared
scaries	scares
sceduled	scheduled
sceptic	septic
sceptical	skeptical
scepticism	skepticism
schatzki	shatzki
schatzkis	shatzki
schau	chat
schedu	schedule
schedualed	scheduled
scheduler's	schedule's
scheelt	sheet
schefuled	scheduled
scheinen	schwinn
schiff	chief
schiffer	shifter
schiffer's	schrieffer's
schiffs	shifts
schitt	schist
schitt's	schist's
schizophrenias	schizophrenia
schlau	scholar
schlimm	schism
schluck	schmuck
schnelle	schelde
schoeff	scoff
schon	scion
schoo	school
schoolbus	schools
schooler	schooled
schor	ichor
schould	should
schr	scar
schreib	schweiz
schrute	chute
schtazy	schmalzy
schulte	schultz
schuster	shutter
sci	ski
scientificly	scientific
scientifics	scientific
scietific	scientific
scifi	shift
scince	since
scintific	scientific
scio	scion
scootch	scotch
scopic	comic
scpd	scud
screamy	scream
scritto	script
scrivere	scriber
sculo	scull
scusami	scutari
sd	so
sdam	slam
seak	speak
seaking	speaking
seamos	seams
searchbar	searcher
searchibg	searching
seasia	season
seasona	season
seater	sweater
seb	see
sebhorreic	seborrheic
sebhorrheic	seborrheic
secondaire	secondary
secondaires	secondaries
seconde	second
secondes	seconds
secours	scours
secutary	sectary
sedations	sedation
seee	see
seeee	see
seein	seen
seeinggn	seeing
seeked	seemed
seeya	see
seeying	seeing
seg	see
seguindo	segundo
seguire	secure
seguito	negrito
segunda	segundo
seguro	secure
sehr	sear
sei	see
seid	said
seift	shift
sein	seen
seing	being
seit	set
seiza	seize
sejam	seam
sek	see
selbst	sells
seldomly	seldom
selfconscious	unselfconscious
selfcured	self-cured
sellner	seller
selon	salon
selv	sell
selve	serve
selvf	self
selzer	seller
selzers	sellers
selzter	seltzer
semaine	remain
semaines	remains
semana	semang
semanas	demands
semble	kemble
semblence	semblance
semeticon	emoticon
seminarium	seminarian
sempre	simple
semptember	september
sendt	send
sendte	senate
senerio	scenario
seninle	senile
sensaci	sensate
sensacion	sensation
sensatation	sensation
sensazione	sensation
senseation	sensation
sensei	sense
sensetive	sensitive
sensical	sensual
sensitivty	sensitivity
sensitivy	sensitive
senstations	sensations
senstion	sensation
sentada	santana
sentado	centavo
sentaient	sentient
sentances	sentences
sentes	senses
senti	sent
sentido	sentimo
sentir	sent
sentirme	entire
sentito	sentimo
sents	sent
senza	senna
sep	see
separaten	separate
sepcialised	specialized
seperate	separate
seperately	separately
seperates	separates
seperating	separating
septermber	september
ser	her
serais	serai
serait	strait
seratonin	serotonin
serem	seem
seri	sari
serie	serve
serieus	serious
sering	seeing
serio	servo
seriosly	seriously
serioulsy	seriously
serveral	several
servere	severe
serverly	servery
ses	see
sesation	sensation
sesh	mesh
setles	settles
sette	settle
seul	sell
seule	see
seulement	element
severa	several
severities	securities
severly	severely
severy	every
sevzral	several
sexytime	seedtime
sf	of
sfincter	spinster
sfintere	sincere
sfinxter	spinster
sfter	after
sg	so
sgb	sub
sgbing	going
sgd	sad
sha	she
shaha	shah
shaing	sharing
shakeer	shaker
shanova	shana
shaolin	stalin
shapira	shapiro
sharimg	sharing
sharma	dharma
sharma's	sharia's
shary	share
shatskis	shatzki
shatzki's	shakti's
shcoked	shocked
shedd	she'd
sheduled	scheduled
sheeesh	sheets
sheeple	steeple
sheeran	sheer
sheesh	she's
shepards	shepard
shephard	shepherd
sheth	seth
shiiit	shit
shiitake	shiite
shimmerist	shimmering
shimmys	shimmy
shindler	swindler
shite	shit
shitless	shirtless
shitshow	scishow
shitter	shutter
shittinf	shitting
shiz	shit
shlew	slew
sho	so
shoeff	shoes
shoet	shot
sholders	shoulders
sholud	should
shooken	spoken
shortlived	shortlisted
shotguned	shotgunned
shotted	spotted
should've	would've
shoulda	should
shoulde	should
shouldn	should
shouldnt	shouldn't
shouldve	should
shoutouts	shootouts
shoven	shove
shre	she
shrooms	rooms
shrumlet	strumpet
shs	she
shuman	human
shyte	shote
siamo	siam
sibilings	siblings
sicas	silas
sicence	science
sich	such
sicher	richer
sickboy	sickbay
sickenss	sickness
sida	side
sidebar'd	sidebar's
sideburps	sideburns
siden	side
sidenote	denote
sido	side
sids	kids
sie	she
siegel	siege
siempre	simple
sienta	siesta
sientas	siestas
siente	sente
sienten	scented
sientes	scenes
siento	into
sife	life
sifo	sift
siga	sign
sige	side
siger	tiger
sightsee	sightseer
signe	sign
signicant	significant
significal	significant
significanyly	significantly
significnttly	significantly
signifigantly	significantly
signt	sign
signup	sign
sigo	sign
sigue	segue
siguen	sign
sikker	sicker
sikkert	sickert
sil	sit
silencio	silence
silverado	silvered
sim	him
sim's	sam's
similair	similar
similan	similar
similares	similar
similiar	similar
simlilar	similar
simmiliar	similar
simo	limo
simpele	simple
simpelt	simple
simpily	simply
simplement	implement
simplemente	implement
simples	simple
simptom	symptom
simptoms	symptoms
simtoms	simooms
sincr	since
sindrome	syndrome
sinds	finds
sinises	sinuses
sinisitus	sinusitis
sinn	sign
sino	sing
sinoscopy	bioscopy
sintesi	sites
sintomas	intimas
sinusit	sinus
sinxe	since
sippable	shippable
sippy	hippy
sirva	silva
sirve	serve
sista	vista
sistema	sister
sitant	start
sitatuons	stations
sitez	site
sittimg	sitting
situaci	situate
situaciones	situations
situatie	situate
situatuons	situations
sitution	situation
sixe	six
sixk	six
sizeless	wireless
sj	so
sjorgen	shorten
sjuksk	sauks
sjukv	juke
sjw	saw
sk	so
sk's	so's
skal	seal
skedros	kedron
skejby	shelby
skete	skate
skicka	sick
skirmishyt	skirmish
skj	sky
skrev	sure
skrevet	street
skriv	skin
skriva	strive
skrive	strive
skriver	skiver
skulle	skull
skulling	skulking
skylus	stylus
skyped	skype
skyrim	skim
sl	so
slc	sly
sld	old
sle	she
slecht	slept
sleepinng	sleeping
slengt	sent
slighest	slightest
slighly	slightly
sligthly	slightly
slikken	silken
slimey	slimy
slimfast	slimmest
slippa	slippy
slippry	slippery
slooowly	slowly
sloow	slow
slooww	slow
slowww	slow
slp	slip
slps	slips
slt	set
sluit	suit
sluiten	suite
slurpees	slurpee
slurpies	slurping
slurrping	slurping
slushees	flushes
slushies	slushier
slynd	send
sma	sea
smaak	smack
smal	small
smalll	small
smallow	swallow
smallowing	swallowing
smallside	smalltime
smartee	smarter
smas	smash
smdh	such
smellz	smell
smerter	smarter
smfew	smew
smfh	such
smh	sh
smiliar	familiar
smol	smog
smoosh	smooth
smooshed	smoothed
smooshing	smooching
smoothe	smooth
smorgasbord	smörgåsbord
smt	set
smtg	smug
smth	smith
smthg	smug
smthn	stun
smuggly	smuggle
snabbt	shabby
snakk	snake
snakket	snake
snarest	snares
snarf	scarf
snarfings	snarling
snarkiness	scariness
snarky	sparky
snart	start
snd	and
sneezy	sneeze
snel	seel
sneller	seller
sniffly	sniffle
sning	sing
sninger	singer
snl	sol
snowbarded	snowboarded
snris	saris
snus	sinus
sobre	sore
soca	soda
socal	local
sociale	social
socialise	socialist
socialising	socializing
sodager	voyager
soemthing	something
soep	step
soepel	steel
soexializes	specializes
soffering	suffering
soffre	joffre
soflo	solo
sofocating	suffocating
sofrem	sore
softners	softness
soigner	signer
soin	son
soir	sir
soirs	stirs
soit	sit
soju	sou
soleil	solid
soley	sole
solicitar	solicitor
solide	solid
soliman	solemn
soll	sell
sollte	solute
solta	sorta
soluci	solace
soluciones	solutions
solventi	solvent
somac	soma
somach	stomach
somaticizing	romanticizing
somatization	romanization
somebiw	somehow
somedays	someday
somehing	something
somehiw	somehow
somehoe	somehow
someitmes	sometimes
someome	someone
somestimes	sometimes
somethig	something
somethimes	sometimes
somethin	something
somethjng	something
sometime's	sometimes
sometimesss	sometimes
sometines	sometimes
someting	something
sometning	something
somewheres	somewhere
somewherw	somewhere
somilar	similar
somit	vomit
sommar	summer
sommige	commie
somone	someone
somos	homos
soms	some
somthing	something
somtimes	sometimes
somwhat	somewhat
somwthing	something
sonds	sounds
sonething	something
sonetimes	sometimes
songez	longer
sonnait	sonnet
sono	son
sonographer	monographer
sonores	snores
sonra	sonar
sont	son
soo	so
soom	room
soonish	spanish
sooo	soon
sooon	soon
soooo	soon
soooon	soon
sooooo	voodoo
sooort	sort
soort	sort
sophage	sophie
sophages	esophagus
sophagus	esophagus
sor	for
soreish	moreish
sorge	sore
sorgen	morgen
sorrounded	surrounded
sorrry	sorry
sorryyy	sorry
sors	sort
sort've	sortie
sorte	sort
sortir	sortie
sortve	sortie
sorundan	soudan
sory	sorry
soso	solo
soudre	sure
souffle	shuffle
souffrance	sufferance
souffrant	bouffant
souffre	suffer
souffrons	saffrons
soulager	boulanger
soulmate	sulfate
soultion	solution
sounda	sounds
souns	sounds
sourz	sour
souvent	solvent
sov	so
sove	some
sowas	sodas
soweit	koweit
sowie	bowie
sowieso	showiest
soylent	solent
soz	so
spaceous	spacious
spadina	spading
spafford	stafford
spaghettios	spaghetti's
spaghettis	spaghetti
spaho	spahi
spammy	sammy
spannend	spanned
spanx	spank
sparkiling	sparkling
spasmed	spammed
spazy	spay
spazz	space
spazzed	spared
spazzes	spaces
spazzing	sparring
spazzy	snazzy
speach	speech
speay	speak
specailists	specialists
speciale	special
specialilst	specialist
specialise	specialist
specialised	specialized
specialises	specializes
specialising	specializing
specialista	specialist
specialisten	specialist
specialister	specialist
specialities	specialties
speciality	specialty
specialt	special
speciffic	specific
speciffically	specifically
specifiek	specified
specifikt	specific
speechie	speech
speedbumps	speedups
spegel	speed
spegiel	special
speigal	special
speigel	spiel
spercialist	specialist
spero	sperm
spesso	specs
sphincher	sphincter
sphinchter	sphincter
sphincty	sphincter
sphinkter	sphincter
sphintcher	sphincter
sphintcter	sphincter
sphinter	splinter
spicey	spice
spiegal	spinal
spiegel	siege
spiegel's	siege's
spiegels	sieges
spigel	spiel
spijt	spit
spikey	spike
spincher	pincher
spincter	spinster
spinkter	spinster
spinny	skinny
spinnys	spinneys
spintcher	pitcher
spirometry	spirometer
spiser	spider
spitt	spit
spleenectomy	splenectomy
splenda	spend
splincher	splinter
splotchiness	blotchiness
spluttery	splutters
spo	so
spontaan	spontoon
spontanious	spontaneous
spontaniously	spontaneously
sporadical	sporadic
sporatic	sporadic
sporatically	sporadically
spp	spy
spreaded	spreader
sprechen	speeches
spredd	spread
spritze	spritz
sprutan	spartan
sprutas	sprouts
spumante	spumone
spunds	sounds
sqeeze	squeeze
squating	squatting
squatty	squat
squeda	squad
squeeked	squeezed
squeeks	squeaks
squeeky	squeaky
squeemish	squeamish
squeez	squeeze
squeezin	squeezing
squeze	squeeze
squick	quick
squicks	quick
squidge	squidgy
squiers	squires
squirrely	squirrel
srbija	sabina
src	arc
sreched	reached
sretched	wretched
srry	sorry
srs	sis
srtaed	stand
srugery	surgery
srumpled	crumpled
sry	say
srz	sri
ssant	slant
sseldorf	düsseldorf
ssen	seen
sshnl	shul
ssia	asia
ssigt	sit
ssl	sol
ssri	sari
ssri's	sari's
ssris	saris
sss	ass
ssssss	assess
staat	start
stabby	shabby
stabilise	stabilize
stabilised	stabilized
stabilises	stabilizes
stabilising	stabilizing
stablised	established
staccato'd	staccato's
stadig	stadia
stahlr	star
staight	straight
stamich	stomach
standaard	standard
standardised	standardized
stanie	stance
stanky	stinky
stappen	happen
starded	started
starteds	started
starten	started
starubucks	starbucks
stategize	statewide
staters	states
statin	station
statrs	starts
stds	studs
stear	swear
stec	step
sted	step
steek	seek
steg	step
steht	stent
steinberg	steinbeck
steken	steven
stel	step
stellan	stellar
stellara	stellar
stelt	smelt
stematil	sematic
stemt	stem
sten	seen
stepdad	stepped
stepmom	stepson
ster	step
sterilise	sterilize
sterilised	sterilized
sterk	steak
sterke	stere
sterkte	sterile
sternam	sternum
sterven	steven
stessed	stressed
steuer	steer
stevia	stevie
stevig	stevie
stewj	stew
stfu	stu
stg	stag
sth	seth
sthat	that
sthg	stag
sthlm	them
sti	sit
stica	stick
stiches	stitches
stickie	stickier
stico	stick
stil	still
stim	swim
stimmy	shimmy
stimoli	stimuli
stimolo	stimuli
stims	swims
stinged	singed
stinnet	stunned
stinnets	sinners
stinnett	sennett
stinton	stanton
stl	sol
stlll	still
stomac	stomach
stomache	stomach
stomaches	stomach's
stomachey	stomached
stomacho	stomach
stomack	stomach
stomsch	stomach
stoner's	stone's
stoners	stones
stong	strong
stonger	stronger
stoped	stopped
storie	store
stormies	stories
stort	start
storys	story
storytime	storyline
str	star
straigh	straight
strang	strong
strangley	strangle
stranglies	strangles
strat	start
strategize	strategic
strats	starts
straub	straus
strava	strata
strawform	strawworm
strawless	strapless
strawlike	starlike
streached	stretched
streadily	steadily
strech	stretch
streched	stretched
streching	stretching
strechtes	stretches
strecke	strike
strect	street
strecth	stretch
strecthed	stretched
strecthes	stretches
streg	strep
stregnthen	strengthen
strenghen	strengthen
strenght	strength
strenghten	strengthen
strenghtened	strengthened
strenghtening	strengthening
strengthing	strengthen
strengthining	strengthening
stresfull	stressful
stressfull	stressful
stressors	stressor
stretchings	stretching
stretta	stretto
striaght	straight
striked	strike
stritctly	strictly
stroboscopopy	stroboscopy
strongbow	strongbox
strugged	struggled
struggeling	struggling
strugggling	struggling
struggleing	struggling
strugglung	struggling
strugled	struggled
strugles	struggles
strugling	struggling
stsrt	start
sttetching	stretching
stucked	sucked
stucking	sticking
stuckness	sickness
stucks	stuck
studie	studied
studieren	studier
studys	study
stuf	stuff
stuft	stuff
stugeron	sturgeon
stuggle	struggle
stuggled	struggled
stuggling	struggling
stumpled	stumbled
stunter	stutter
stupif	stupid
sturen	sure
sturggling	struggling
stuurde	sturdy
styra	styrax
su	so
sua	sun
subbreddit	subreddit
subbredit	subedit
subdirect	subdirector
suberddit	subreddit
subi	sub
subluxation	subjugation
subluxing	subduing
submited	submitted
suboptimally	suboptimal
suboxone	suboxide
subrebbit	subreddit
subred	subbed
subredddit	subreddit
subreddit's	subreddit
subredditors	subeditors
subreddits	subreddit
subredit	subedit
subredits	subedits
subresdit	subreddit
subsidied	subsidies
subsidise	subsidize
subsidised	subsidized
substaintial	substantial
substancial	substantial
subteddit	subreddit
subtletie	subtleties
subtley	subtle
succ	such
succceed	succeed
succes	success
succesful	successful
succesfull	successful
successfu	successful
successfull	successful
successfuly	successful
succesvol	successor
sucede	suede
suceder	sucker
sucess	success
sucessful	successful
sucessfull	successful
sucessfully	successfully
suchen	kuchen
suchhh	such
suckable	suitable
suckage	package
suckeddd	sucked
suckin	sucking
suckk	suck
sucksss	success
sucralose	sucrose
sudafed	sedated
sudam	sudan
suddenr	sudden
suddently	suddenly
suele	suede
suerte	sure
suf	sun
sufferin	suffering
sufferring	suffering
suffi	suffix
suffit	suffix
sufr	surf
sufre	sure
sufria	sofia
sufrir	suffer
sufro	sure
sugarcube	sugarcane
sugery	surgery
sugest	suggest
suggs	suggest
sugiri	sugar
suhoor	school
suicidality	suicidally
suis	suit
sujet	suet
sujets	suits
sul	sun
sulfer	suffer
sulfites	sulfite
suliman	suleiman
sulis	sulks
sulkijan	sullivan
sultat	sultan
sultats	sultans
sulution	solution
sumado	sumo
suman	human
summan	summon
summarise	summarize
summarised	summarized
summarising	summarizing
summate	summat
summerize	summarize
summersaults	summersault
sumpthin	sumption
sumup	sunup
sunil	until
sunnybrook	donnybrook
suny	sun
suoer	super
suparna	sparta
superagastic	supragastric
superato	superego
superbe	superb
superbloat	superblock
superceded	superseded
superfood	supercool
superfun	superfund
supergastric	supragastric
superhumans	superhuman
supernice	supervise
superrr	super
superrrr	superior
suplement	supplement
supongo	sponge
supoose	suppose
suppl	supply
supporr	support
suppos	suppose
suppprt	support
supppsed	supposed
supps	sups
supragastic	supragastric
supragatric	supragastric
supragrastic	supragastric
suprep	sure
supress	suppress
supressed	suppressed
supressing	suppressing
suprise	surprise
suprised	surprised
suprising	surprising
suprisingly	surprisingly
suractant	surfactant
sureee	sure
surfectant	surfactant
surferring	suffering
surfsides	subsides
surg	sure
surgary	surgery
surgeru	surgery
surgerys	surgery
surgey	surgery
surggery	surgery
surgi	surge
surgoens	surgeons
surgury	surgery
surmontables	surmountable
surpress	suppress
surpressed	suppressed
surpressing	suppressing
surroundingit	surrounding
surtain	curtain
sus	us
suspiscious	suspicious
sutep	step
sutter	butter
sutter's	butter's
suuper	super
suuuch	such
suuucked	sucked
suuucks	sucks
suuuper	super
suver	super
suxx	sure
sv	so
svalg	shall
svar	star
svarar	sarah
svarte	start
svas	seas
svc	sec
svensk	sense
svt	set
swalling	swelling
swalllowed	swallowed
swalloing	swallowing
swallong	swallow
swallowable	allowable
swallowers	swallower
swallowign	swallowing
swalow	swallow
swalowing	swallowing
sweety	sweet
swelly	swell
swfl	safe
swiftie	swift
swiming	swimming
swimteam	swimwear
swinda	wind
swole	stole
swollow	swallow
swollowing	swallowing
sx	so
sxs	sis
sxsw	saw
sy	my
sya	say
sychronization	synchronization
sykehus	sykes
symbicort	symbiont
sympa	spa
sympathise	sympathize
symprove	improve
sympstoms	symptoms
sympt	slept
sympthoms	symptoms
symptome	symptoms
symptomen	symptoms
symptomer	symptoms
symptomes	symptoms
symptomology	symptomatology
symptomy	symptoms
sympton	symptom
symptones	symptoms
symptons	symptoms
symptoom	symptom
symtom	symptom
symtoms	symptoms
symtpms	systems
symtpoms	symptoms
syndome	syndrome
syndrom	syndrome
syndroms	syndrome
synergize	energize
synes	syne
synptoms	symptoms
synthesised	synthesized
syprise	surprise
syptom	symptom
syptomes	symptoms
syst	cyst
systeem	system
systemet	system
syuj	shut
szpitali	spital
t'ai	tai
t'assure	assure
tac	tax
tachycardic	tachycardia
tacobell	tarbell
tacs	tabs
tada	tad
tadaa	today
taff	staff
tagamet	agamete
tage	take
tagen	taken
tager	eager
tagit	tacit
taht	that
taient	talent
taill	till
tait	wait
tak	take
takedown	facedown
takk	take
takl	take
tal	talk
talia	italia
talkin	talking
tallcans	lallans
talso	also
tama	mama
tamas	mamas
tamb	lamb
tambi	bambi
tambien	ambient
tambor	tabor
tampoco	tampico
tant	want
tantalisingly	tantalizingly
tantos	santos
taobacco	tobacco
tappy	happy
tapwater	tapster
taramaslata	taramasalata
tard	hard
tardes	trades
tardive	arrive
tareck	track
tarzana	tarzan
tas	was
tasered	tapered
tassie	lassie
tasteable	tastable
tastebud	tasted
tastic	tactic
tastless	tasteless
tatse	taste
tatt	tart
tattershall	tattersail
tatts	tarts
taubman	tubman
tauggt	taught
tauntaun	taunton
tavns	tans
tays	says
tbat	that
tbc	tic
tbd	tad
tbe	the
tbell	tell
tbey	they
tbf	tb
tbfh	tofu
tbh	tb
tbi	ti
tbis	this
tbs	tabs
tbt	tit
tca	tea
tcas	teas
tch	itch
tcpd	rcpd
td	to
tdlr	tldr
tdot	dot
tdy	try
teached	reached
teaspooon	teaspoon
teather	teacher
tech	teach
techniker	techier
technnique	technique
tecla	tesla
tecnica	technical
tecnique	technique
tecta	testa
tecter	tester
tedonitis	tendonitis
teeeeny	teeny
teethy	teeth
tegen	teen
tego	ego
teh	the
teheee	there
tehy	they
teil	tell
teilen	toilet
tej	ten
teknon	tenon
tel	tell
teledoc	toledo
teledocs	telecoms
televisi	televise
tellement	element
telll	tell
telogen	halogen
tem	them
tema	team
temat	tempt
tement	cement
temporaires	temporaries
temporality	temporarily
temporarely	temporarily
tempory	memory
tence	fence
tendancy	tendency
tendr	tend
tenemos	tenedos
tener	tender
teng	ten
teng's	tent's
tenga	tonga
tengan	tongan
tengo	tango
tenho	tenno
tenian	fenian
tenido	tend
teniez	denied
tensioning	pensioning
tentar	tenter
tention	mention
teo	to
teor	tear
tequnique	technique
ter	her
terapy	therapy
tere	there
terebrad	cerebral
terecht	erect
terme	terms
termers	terms
termijn	vermin
termin	vermin
terminer	terminal
terrasse	terrace
terrifiedly	terrified
terrrible	terrible
terska	terra
terst	test
terwijl	terrill
tes	ten
tesco	teach
teste	test
testerday	yesterday
tete	tee
tetracyclic	tetracycline
teuer	truer
teux	tux
teva	tea
texted	tested
texting	testing
textote	texture
tf	to
tg	to
tgis	this
tha	the
thaaanks	thanks
thaaats	threats
thab	that
thaf	that
tham	that
thanfkully	thankfully
thang	than
thanka	thank
thankings	thanking
thanku	thank
thankuu	thank
thanky	thank
thanl	than
thann	than
thans	than
that'd	that's
that'll	that's
that're	that's
that've	that's
thata	that
thatll	that
thats	that
thattt	that
thay	that
thays	trays
thb	the
thc	the
thc's	tc's
theanine	thiamine
theate	theater
theb	the
theee	there
theeeee	therese
theloud	cheloid
themself	himself
themselfes	themselves
thennn	then
theno	then
theo	the
theoat	throat
theoreon	thereon
theoreon's	theorem's
theorically	theoretically
theorise	theories
theorised	theorized
theorises	theories
theorising	theorizing
ther	the
therapod	theropod
theraputic	therapeutic
therapy'd	therapy's
there'd	there's
there'll	there's
there're	there's
theres	there
theroy	theory
thest	these
thethe	teethe
thetwo	ghetto
theur	their
thevoice	devoice
theyd	they
theygave	they've
theyll	they'll
theyre	there
theyve	they've
theyy	they
thge	the
thi	the
thia	this
thiamax	thiamin
thibk	think
thid	this
thier	their
thight	tight
thigs	this
thiiink	think
thikn	think
thinge	thing
thingeys	things
thingie	thingies
thingis	things
thinkin	thinking
thioctic	thionic
this'd	this
this'll	they'll
thise	this
thish	this
thisl	this
thiss	this
thissss	hisses
thje	the
thjnk	think
thk	the
thknk	think
thks	this
thnk	think
thnx	the
thoat	that
thode	those
thoight	thought
thoothbrush	toothbrush
thorne	throne
thorugh	through
thoses	those
thoughh	thought
thouht	thought
thourgh	though
thourougly	thoroughly
thqt	that
thr	the
thraot	throat
thrat	that
threatment	treatment
threre	there
thrivin	thriving
thrkugh	through
throad	throat
throart	throat
throata	throat
throatal	throat
throath	throat
throaties	throatier
throating	troating
throattox	throatox
throay	throat
throtox	throatox
throug	through
throughly	thoroughly
throughouth	throughout
throught	thought
throuout	throwout
throut	throat
throwed	thrower
throwup	throw
throwups	throws
thryve	thrive
ths	the
thse	the
thst	that
thsy	they
tht	the
ththe	tithe
thts	this
thunk	think
thunks	thanks
thusfar	hussar
thw	the
tianhe	trance
tibbetts	gibbets
tickeling	tickling
tickley	tickle
tico	tick
ticos	tacos
tid	did
tiddies	kiddies
tiden	tide
tiempo	tempo
tiene	tine
tienen	teen
tienes	tines
tieniest	tiniest
tiens	ties
tient	tent
tietze	title
tiez	tie
tig	big
tighening	tightening
tighetning	tightening
tighness	highness
tigthen	tighten
tigther	tighter
tihnk	think
tiiiny	tiny
tijd	tied
tijdens	tides
tijdje	tide
tiktacs	titans
tiktoc	tiktok
tiktocs	tiptoes
tiktoks	tiktok
tilbage	tillage
tilbake	tillage
tilbudt	tilburg
tilgang	tilting
tilv	till
timeand	timed
timelines	timeline
timey	time
timy	time
tinies	tiniest
tinittus	tinnitus
tinitus	tinnitus
tinnny	tinny
tinyyy	tiny
tio	to
tipo	tip
tipoff	ripoff
tipp	tip
tipps	tips
tiramasu	tiramisu
tirdi	third
tis	is
tithings	tithing
tition	tuition
titos	tits
tive	give
tiya	tina
tj	to
tja	tea
tjb	tub
tje	the
tjis	this
tk	to
tlc	tic
tlginger	ginger
tlou	thou
tminstone	tinstone
tmjs	tm's
tmr	tar
tmro	taro
tmrw	try
tmw	tow
tn	to
tnx	tax
toastie	toastier
toc	to
toch	touch
toda	today
todas	today
todav	today
todays	today
todisco	disco
todo	too
todos	dodos
toearn	learn
toen	then
toepassing	trespassing
togd	told
togeather	together
togehter	together
toget	roget
togethers	together
togheter	together
toi	to
tok	to
toker	tower
tokers	towers
toledoan	toledo
toleraba	tolerate
tolerence	tolerance
tolero	bolero
tollerable	tolerable
tomada	tomato
tomando	tomato
tomar	omar
tomara	tamara
tomatoe	tomato
tomgi	tough
tommarrow	tomorrow
tommorow	tomorrow
tomo	too
tonge	tongue
tonite	tongue
tonk	took
tonsilitis	tonsillitis
toobin	toxin
tooks	took
toolset	toilet
toooo	too
toooons	cocoons
tooooo	voodoo
tootbrush	toothbrush
tootie	tootsie
tootin	tooting
toov	too
topam	topaz
toprimate	primate
tornio	torino
torrington	harrington
tos	to
totaal	total
totale	total
totaly	totally
toture	torture
tou	you
touffer	offer
tought	thought
toughts	thoughts
tounge	lounge
toungue	tongue
tourette	roulette
tourettes	burettes
tourner	turner
tous	tour
toute	route
toutes	routes
touw	tour
towner	owner
towners	owners
tox	to
tox'd	told
toxed	boxed
toxine	toxins
toxix	toxic
tp	to
tpa	tea
tpically	typically
tpn	ten
tpo	to
tps	tips
tr	to
tra	try
trabajo	rabato
trabajos	rabatos
tracto	tractor
tradies	trades
tradional	traditional
traducteur	traducer
traduction	production
traductor	tractor
tragar	tragic
tragedia	tragedian
traitant	irritant
traitera	traitor
traitment	treatment
trange	strange
tranger	stranger
tranquillo	tranquilly
transexual	transsexual
transexualism	transsexualism
transf	trans
transfered	transferred
transformative	transformation
transl	trans
transmis	transmit
transoral	transferal
transversa	transverse
traped	trapped
trappd	trapped
trappes	trapped
trapt	trap
tras	trash
trasfered	transferred
traslate	translate
trata	strata
tratar	tartar
tratarse	traverse
trate	trade
traumatised	traumatized
traumatising	traumatizing
travell	travel
traying	trying
tre	the
treament	treatment
treaments	treatments
treatement	treatment
treaters	theaters
treatmen	treatment
trembel	tremble
tremendeously	tremendously
tremendo	tremendous
trenger	stronger
tres	tree
trhough	through
trhow	throw
trhowing	throwing
tri	try
triaged	triage
triaging	trialing
trialling	trilling
tricare's	triage's
tricep	triceps
trie	tried
trifecta	trisect
triggery	trigger
trigging	frigging
trigo	trio
tring	thing
trinken	trinket
trinkst	trinket
tripples	ripples
trippy	drippy
tris	this
trise	rise
tritter	critter
tritter's	critter's
triying	trying
tro	to
troath	troth
troble	trouble
trodde	trodden
trop	top
tror	trot
troublingly	troubling
trought	thought
trouv	trout
trouve	troupe
trouver	trouser
trouveras	trousers
trouwens	trousers
trratment	treatment
trt	try
truc	true
trudi	trudy
trueeee	trustee
truely	truly
truett's	truth's
trulance	trance
truly's	trudy's
trused	trusted
tryna	trina
tryyy	try
tsa	tea
tshirt	shirt
tshirts	shirts
tsk	ask
tske	take
tt	to
tta	tea
ttar	star
tte	the
ttebra	zebra
tteg	the
ttfd	told
tting	thing
ttre	tore
tuah	tush
tubey	tube
tudca	tuck
tudes	dudes
tudiants	mediants
tudo	judo
tuened	turned
tuer	tier
tule	rule
tullio	tulip
tully	fully
tumbado	lumbago
tumms	tummy
tumour	tumor
tumours	tumors
tumtum	tutu
tunnare	tunnage
tuo	to
tur	our
turbinade	turbinate
turid	turd
turo	turn
turun	turn
tus	us
tusen	then
tuss	toss
tussen	tossed
tutaj	total
tuto	auto
tutta	outta
tutte	tutti
tuvan	than
tuve	tune
tuyo	to
tve	the
tvekar	tear
tw	to
tweas	tweak
tweede	tweed
twich	twice
twils	twins
twinsburg	ginsburg
twinsies	twinkies
twinssss	twinsets
twizzler	twizzlers
twoish	wish
tx	to
txs	t's
tyanks	thanks
tyhoid	typhoid
tyia	tia
tyks	tyke
tylenols	tylenol
tym	gym
typ	top
typa	type
tysm	them
tyt	tit
tyvm	them
tzend	tend
uab	lab
uae	use
uams	jams
uanesthetized	anesthetized
uars	cars
ubc	ubs
uber	user
uber'd	user's
ubered	bored
ubering	bering
ubers	users
ubice	bice
uchealth	health
uci	uni
ucirvine	cervine
ucsd	us
ucsf	us
ud	up
uda	una
udca	idea
uden	den
udf	udo
udible	audible
udo's	do's
udon	upon
udpate	update
uds	us
uegh	ugh
ues's	tues's
uesd	used
uess	guess
uf	of
uffda	luffa
ug	up
uge	use
uger	user
uges	uses
uggg	ugly
ughh	ugh
ughhh	ugh
uhg	uh
uhh	uh
uhhh	uh
uhip	ship
uhm	uh
uhmm	hmm
uhn	uh
ui	i
uit	it
uitleg	title
uitstel	listel
uitvinder	uitlander
uke	use
uker	user
ul	up
ulcering	altering
ulcurs	ulcers
uld	old
ull	all
ultimaly	ultimacy
ultracare	ultrapure
ultrasounded	ultrasound
uluru	lure
uma	ma
umas	mas
umc	um
ume	me
umm	mum
ummm	mom
ummmm	mummy
umr	um
umst	must
un	in
unability	inability
unalive	unalike
unapologetically	apologetically
unas	una
unbareable	unbearable
unbeareable	unbearable
unbedingt	unbending
unblended	blended
unbloat	unload
unbloated	bloated
unbothered	bothered
unbotton	unbutton
unburpable	burpable
unburped	unburied
unburpers	usurpers
unburpies	unburied
unc	una
uncarbonated	carbonated
uncatch	unlatch
unchewed	chewed
uncomfort	comfort
uncomfortablness	uncomfortableness
uncomfotable	uncomfortable
uncomfrtable	uncomfortable
uncomfy	comfy
uncommanded	commanded
uncompromised	compromised
unconciously	unconsciously
unconfident	confident
unconfortable	uncomfortable
unconteollably	uncontrollably
uncontrolable	uncontrollable
unconvential	unconventional
uncounsciously	unconsciously
uncurable	incurable
und	and
undble	unable
underate	underage
undereat	underneath
undereating	underrating
underexplored	underemployed
underreact	underact
unders	under
undersdant	understand
undershared	understated
underson	anderson
understant	understand
understryk	understory
undertrained	unrestrained
undertreated	underrated
underwire	undermine
underwires	undermines
undesolved	unresolved
undestand	understand
undestood	understood
undiganosed	undiagnosed
undigestable	indigestible
undigestible	indigestible
undisputably	indisputably
undoubtable	uncountable
undoubtably	undoubtedly
undrar	under
undrunk	drunk
une	one
unecessary	necessary
unempathetic	unsympathetic
unevacuated	unevaluated
unexpectadly	unexpectedly
unexpelled	unexcelled
unfarted	unarmed
unfitter	unfetter
unfixable	unlikable
unflavoured	unflavored
unflex	uncle
unflexing	flexing
unfocus	focus
unfomortable	uncomfortable
unfortunateley	unfortunately
unfortunatelly	unfortunately
unfortunatley	unfortunately
unfortunatly	unfortunately
unfuck	untuck
unfun	fun
ungraphic	graphic
unhc	uhc
unhealthcare	healthcare
unhealthly	unhealthy
unheavenly	heavenly
unhelped	helped
unhh	bunch
unic	unit
unica	utica
unicors	unicorn
unidos	units
uninjected	uninfected
unintenionally	unintentionally
unintention	intention
unintently	intently
unintuitive	intuitive
uniqlo	unique
unironically	ironically
unisoms	unisom
univeristy	university
universit	university
universtity	university
univesity's	university's
unkink	unkind
unlady	unlade
unlearnt	unlearn
unlesss	unless
unluckly	unlucky
unlv	univ
unm	um
unmc	unit
unmedicated	unmediated
unmuffled	unruffled
unneccesarily	unnecessarily
unneccessarily	unnecessarily
unneccessary	unnecessary
unnecesarry	unnecessary
unnormal	normal
unnoticable	unnoticeable
uno	no
unopening	opening
unoptimistic	optimistic
unordinary	ordinary
unpainful	painful
unparalyze	paralyze
unphased	phased
unpleasantries	pleasantries
unpleasent	unpleasant
unproportional	proportional
unrealiable	unreliable
unrecognised	unrecognized
unrelatable	unreliable
unrelaxed	unrelated
unrelaxing	relaxing
unreleasable	releasable
unrelievable	unbelievable
unrelieving	unbelieving
unresearched	researched
uns	us
unsatisfyingly	unsatisfying
unsexy	unsex
unsore	unsure
unstretch	stretch
unsuccesful	unsuccessful
unsuccesfully	unsuccessfully
unsupportive	supportive
unsurprisngly	unsurprisingly
unsuscribed	unsubscribed
untameable	unnameable
unter	under
untill	until
untim	until
untl	until
untoasted	untasted
untolerable	intolerable
untraining	entraining
untrapped	untapped
unusualness	usualness
unvoluntarily	involuntarily
unware	unaware
unwellness	wellness
unwhole	whole
unwieldly	unwieldy
uo	to
uodate	update
uofa	sofa
uoft	soft
uofu	tofu
uofu's	tofu's
uom	mom
uos	us
uou	you
upchucky	upchuck
updatet	update
upenn	penn
upet	upset
upfont	upfront
upleasant	pleasant
uploadet	uploaded
uploarding	uploading
upmc	up
upni	uni
upp	up
uppbl	upper
uppdatera	updater
upperbody	underbody
uppringning	upbringing
upto	unto
upup	pup
upvote	vote
upvoted	voted
upvotes	votes
upvoting	voting
upy	up
ure	are
urgh	urge
urghh	urge
urhhh	uriah
urnination	urination
urp	up
urping	urging
urps	ups
urpy	urey
urqent	urgent
urs	us
urself	ourself
usally	usually
usar	user
usc	us
uscs	uses
usd	us
uselfull	useful
uselless	useless
usernames	username
usf	us
uso	so
ussi	us
ussual	usual
ussually	usually
ussues	issues
usuall	usually
usuallly	usually
usualy	usually
ususal	usual
ususally	usually
usw	us
uta	ta
utahns	utah's
utan	tan
utd	ut
utero	uteri
utf	ut
utg	tug
uthealth	health
uti's	ti's
utifall	pitfall
utilis	utility
utilise	utilize
utilised	utilized
utilisera	utilizer
utilising	utilizing
utiliz	utilize
utilizo	utilize
utilizzo	utilize
utis	unis
utn	urn
utredning	trending
utsw	uts
utv	ut
uuugh	tough
uuup	up
uuuu	guru
uva	una
uve	use
uw	up
uwm	um
uz	up
uza	una
uzg	uzi
uzl	uzi
v'ed	vied
v'ing	vying
vaak	vaal
vaca	vac
vaccation	vacation
vaccin	vaccine
vaccum	vacuum
vaccume	accuse
vaccuums	vacuums
vacu	vac
vacume	value
vad	had
vaf	van
vag	bag
vagally	legally
vaginaing	paginating
vaginosis	vaginitis
vagnismus	vaginismus
vagul	vague
vahc	vac
vai	van
vais	vain
vakuum	vacuum
valeu	value
validdd	valid
vallari	mallard
valsa	salsa
vanaf	van
vandaag	handbag
vandaar	vandals
vanlige	vantage
vant	want
vanuit	vault
vanwege	vantage
vap	map
vaped	raped
vapers	papers
vapes	tapes
vaping	raping
vapour	vapor
vardagen	yardage
vare	are
varf	vary
variadas	variants
varias	varies
varie	varied
variedad	varied
varier	varied
varios	various
varit	varia
varrying	carrying
varsa	vaasa
vart	part
varte	carte
vasculature	musculature
vasten	fasten
vau	van
vaut	vast
vax	van
vaxed	faxed
vaxers	taxers
vaxxed	valued
vaxxines	vaccines
vayas	mayas
vc	vic
vcd	cd
vcs	vas
vd	ad
vde	de
ve	we
veces	vices
vecka	neck
veckor	vector
ved	red
vede	cede
vedo	redo
veeeel	vessel
veeeery	veneer
veeerry	veery
veeery	veery
veel	feel
veen	been
vegeterian	vegetarian
vegitarian	vegetarian
vego	ego
velasquez	velásquez
velat	veldt
veldig	vending
vele	vile
vellore	deplore
velse	else
velser	else
veltliner	jetliner
venait	vent
vende	venue
venho	venlo
ventalin	ventolin
vente	vent
ventet	vented
ventre	venture
veo	vet
ver	her
verbalising	verbalizing
verdad	verbal
verder	herder
verduras	verdun's
vergeht	verge
verh	very
verhaal	verbal
veriety	variety
verkade	verde
verkar	verbal
verkeerd	vermeer
verlichting	vellicating
verliert	verier
verma	vera
verma's	vera's
vermas	dermas
vermut	permit
vero	very
verpest	veriest
verps	verbs
verrais	terrain
verrry	very
verry	very
vers	very
versa	verse
versary	adversary
versea	verse
verste	verse
versuche	verrucae
veru	very
veruca	verruca
verv	very
veryy	very
veryyy	very
vess	less
vettig	vetting
veut	vet
veux	vex
vey	very
vez	vet
vfss	miss
vgh	ugh
vhi	hi
vhs	vas
vi	i
viajar	vicar
vibing	viking
vibratey	vibrate
vicioso	vicious
vicks	picks
vicodin	violin
vics	vice
victime	victim
vid	did
viden	video
videoable	viewable
videod	video
videoda	video
videre	video
vidrig	vibrio
vids	kids
vidt	vida
viele	vile
vielen	violent
viene	vine
vienen	vienne
viens	views
vient	vent
vieram	viral
vierge	verge
vieux	view
vigtige	vintage
vii	via
viii	veii
vil	evil
vilari	vicar
vilas	vials
vildt	veldt
vilja	villa
vilka	villa
vill	will
villari	village
villari's	villains
ville	vile
villiari	billiard
vimeo	video
vimto	vito
vincents	vincent
vind	find
vinden	linden
vindo	vino
vinger	finger
vinyasa	nyasa
viome	biome
virker	worker
virket	market
visade	visage
viscious	vicious
visio	visit
visitado	visited
visitar	visitor
visite	visit
visiualise	visualize
vissa	visa
visst	visit
visste	visit
viste	vista
visted	visited
visto	vista
visualisation	visualization
visualise	visualize
visualised	visualized
visualiser	visualizer
visualising	visualizing
vit	it
vitables	tables
vitale	vital
vite	vote
viterait	literati
vivanse	divans
vivement	movement
vivido	vivid
vivir	vivid
vivo	vive
vk	ok
vla	la
vlige	like
vlogged	logged
vlogging	logging
vlogmas	dogmas
vm	am
vn	in
vnev	nev
vo	to
vobpw	vow
voc	vow
vocaci	vocal
vocalisation	vocalization
vocalisations	vocalizations
vocalise	vocalist
vocalised	vocalized
vocalising	vocalizing
vod	god
voel	vowel
voelde	vole
voelen	pollen
voelt	volt
voered	veered
voi	vow
voicebox	icebox
voici	voice
voil	oil
voila	viola
voir	void
vois	vows
vokes	jokes
vol	vow
volgens	volleys
voll	roll
volle	volley
volont	volant
volubtary	voluntary
volumous	volumes
volver	solver
vom	mom
vom'd	you'd
vom'ed	voted
vombut	combat
vomd	void
vometing	vomiting
vomica	voice
voming	coming
vomir	vomit
vomitar	vomiter
vomitare	voiture
vomiters	vomiter
vomitfor	vomitory
vomith	vomit
vomithed	vomited
vomitinf	vomiting
vomititng	vomiting
vomitted	vomited
vomitter	vomiter
vomitters	emitters
vomitty	vomit
vomity	vomit
vommed	voted
vomming	coming
vommit	commit
vommited	vomited
vommiting	vomiting
vommits	commits
vommitted	committed
vommitting	committing
vommon	common
vommy	mommy
vomoting	vomiting
voms	moms
vomting	voting
von	on
vond	fond
vondt	vonda
vonit	vomit
voor	door
vooral	moral
voordat	doormat
vor	for
vorab	grab
voraus	virus
vorbeif	corbeil
voren	oren
vorher	other
vorig	boring
vorige	voice
voronoi	moroni
vorteil	vortex
vorteile	tortile
vos	cos
voss	boss
votar	voter
votox	botox
votre	vote
vou	you
voulais	coulis
vour	your
vous	vows
vox	box
voy	boy
voyag	voyage
voz	vow
vraag	drag
vragen	dragon
vraiment	raiment
vrbo	rob
vreemd	freed
vrees	trees
vrier	drier
vrigt	right
vrij	rid
vroeg	roeg
vse	use
vsg	veg
vsl	val
vu	u
vuelta	delta
vuelvo	vulva
vulnerarble	vulnerable
vuoi	vow
vurped	burped
vurping	burping
vurps	burps
vvvv	vive
vyanse	vase
vyvance	advance
vyvy	very
wa	a
waa	was
waaaa	wanna
waaaay	waylay
waaay	way
waah	wash
waar	war
waard	award
waarin	wearing
waay	way
waayy	way
wacht	yacht
wachten	watchmen
wacken	waken
wackest	wackiest
waddeling	waddling
wafflish	waffles
wahey	whey
wahhh	watch
wahlen	when
waht	what
wainting	waiting
waitbands	waistbands
waitin	waiting
waitlisted	waitlist
waitlists	waitlist
waitrose	waitress
waittt	wait
wakeup	makeup
wakeups	makeups
wakker	walker
wakko	wacko
walgreens	walgreen
walyas	ways
wammy	mammy
wana	want
wangs	wants
wann	want
wanneer	wanner
wanntt	want
wanto	want
warbly	warmly
waren	warn
wariza	maria
warum	warm
wasen't	wasn't
wasn	was
wasnt	want
wason	wagon
wasserman	washerman
wate	hate
waterboard	paperboard
waterboarding	weatherboarding
wateringly	waveringly
watford	afford
waveney	wakened
wavery	watery
wavey	wave
wayer	water
wayy	way
wayyy	way
wayyyy	waylay
wc	we
wdym	why
weaking	wearing
weats	beats
webinars	webinar
webmd	we'd
webnar	webinar
webpages	webpage
wednstay	wednesday
weee	were
weeee	were
weeeks	weeks
weej	week
weekes	weeks
weet	went
weez	week
weg	we
wege	were
wegging	begging
wegs	legs
weh	we
wehre	were
weightlift	weightlifter
weightloss	weightless
weil	well
weinig	being
weirdass	weirdest
weirded	weirder
weirdl	weird
weirds	weird
weired	weird
weit	went
weiteren	western
weken	woken
wel	we
welbeck	wetback
welche	welch
welchen	welched
welecome	welcome
welkom	welcome
wellbeing	welling
welll	we'll
wellmark	hallmark
welp	help
wels	well
wende	wendy
wendella	wendell
weniger	wringer
wenn	went
weow	wow
werd	were
werde	were
werden	warden
weren	were
werent	weren't
werk	were
werken	weaken
werkende	weekend
werkt	wert
werkte	were
wernt	went
werthers	weathers
wes	we
westin	weston
weten	ween
weve	were
wever	never
wexner	werner
wf	of
wfh	of
wfpbd	wiped
wgo	go
wha	what
whaa	what
whaaat	what
whaat	what
what're	what's
whatcha	watch
whatever's	whatever
whattt	what
whatttt	whatnot
whatvis	what's
whay	what
wheee	where
wheeeew	wheeled
wheening	wheezing
whehter	whether
whene	when
whenw	when
wherabouts	whereabouts
wheras	whereas
whered	where
whete	where
wheter	whether
wheyy	whey
whi	who
whichs	which
whicj	which
whiich	which
whimpy	wimpy
whiole	whole
whiplashed	whiplashes
whisping	whipping
whitebeard	whiteboard
whiteclaw	whitecap
whiteclaws	whitecaps
whith	with
whithout	without
whitout	whiteout
whitouth	whiteout
whn	when
whoah	whoa
whoelgrains	wholegrain
wholeass	wholeness
wholle	whole
whoohoo	hoodoo
whoole	whole
whooole	whole
whoooops	whoops
whooosh	whoosh
whoopie	whoopee
whoppie	hippie
whos	who
whove	whole
whst	what
wht	what
whuxh	which
whwt	what
whyyy	why
wi	i
wich	with
widly	widely
wie	we
wieder	wider
wiem	diem
wierd	weird
wif	if
wifes	wife
wifi	wife
wij	win
wil	will
willem	willed
willen	willed
willl	will
willst	wills
wilp	will
wim	him
windedness	mindedness
windeze	winded
windezes	indexes
winer	wine
wingo	wings
wingstop	winston
wir	war
wird	word
wirh	with
wirhin	within
wirst	first
wisconsite	wisconsin
wisdome	wisdom
wishinig	wishing
wishkey	wishes
wishy	wish
wissen	nissen
wisten	listen
witb	with
withen	within
withiut	without
withour	without
withouy	without
withrow	throw
withthe	withe
wk	we
wkd	wed
wki	ski
wkll	will
wks	was
wlost	lost
wls	was
wn	in
wnst	west
wnt	want
wny	why
woah	noah
woaw	wow
wochen	when
wod	word
wodering	wondering
wodka	vodka
wohala	whale
wohl	wool
wohoo	wahoo
woild	would
wollte	wallet
women's	woman's
womens	women
wondeful	wonderful
wonderfull	wonderful
wonka	wonky
wonka's	wonk's
woodhall	woodhull
woodson	woods
woohoo	boohoo
woohooo	boohoo
wookie	cookie
wooo	wood
wooohoo	boohoo
woooo	woods
wooooot	woodlot
woop	wood
woopy	woody
woosh	whoosh
woosy	woody
woot	foot
woowoo	voodoo
worden	wooden
wordt	word
woried	worked
workes	worked
workin	working
worrried	worried
worrry	worry
worseee	worse
worsefor	worser
worseners	worsened
worsense	worsens
worsttt	worst
worthing	northing
worths	worth
woth	with
wou	you
woudl	would
woudln	would
woukd	would
woukdnt	wouldn't
would't	wouldn't
woulda	would
wouldn	would
wouldnt	wouldn't
wouldve	would've
wouls	would
wowow	wood
woww	wow
wowww	wow
wowza	wow
wowzers	powers
wpa	spa
wre	we
wretching	retching
wretchy	wretch
writting	writing
wroks	works
wrose	wrote
wrt	art
ws	is
wt	it
wtaf	what
wtfery	watery
wtfff	stuff
wth	with
wtih	with
wurde	were
wurden	burden
wut	but
wv	we
wy	we
wym	gym
xbox	box
xc	xu
xd	ad
xdd	add
xelkurs	velours
xent	went
xeomin	vermin
xico	rico
xie	die
ximo	limo
xiphiod	xiphoid
xito	vito
xl	al
xo	to
xonvea	convey
xox	box
xoxo	too
xoxox	xerox
xp	up
xposted	posted
xq	xu
xr	or
xs	is
xx	ex
xxx	six
xy	my
xylitol	xylol
xylocaine	holocaine
xyz	byz
xyzal	gyral
y'all's	y'all
y'alls	y'all
y'know	know
ya'll	y'all
ya'lls	calls
yaa	ya
yaaaa	yamaha
yaaay	away
yada	ada
yadda	add
yael	yale
yahp	yah
yakkin	yakking
yaknow	know
yakubu	yakut
yakult	yakut
yall	all
yalls	calls
yano	yank
yapan	japan
yardwork	artwork
yas	was
yasmeen	basemen
yass	ass
yassss	passes
yat	at
yay	say
yayay	away
yayayay	layaway
yayuh	yah
yayy	any
yayyy	yappy
yday	day
yeaa	year
yeaaars	years
yeaah	yeah
yeahh	yeah
yeahhh	yeah
yeal	real
yeap	year
yeeees	reeves
yeees	yeses
yeeey	needy
yeehaw	heehaw
yees	eyes
yeesh	eyes
yeet	meet
yeeting	meeting
yeh	yet
yello	hello
yepp	yep
yeppers	peppers
yeppp	yep
yeras	years
yerba	jerba
yers	years
yesdid	redid
yeserday	yesterday
yesrs	years
yess	less
yessir	lesser
yesss	yeses
yessss	messes
yestarday	yesterday
yestersay	yesterday
yets	gets
yeup	yep
yeux	you
yey	yet
yeyyy	feyly
yfoods	foods
yfw	yaw
ygm	gym
yh	oh
yhat	that
yhe	the
yhen	when
yhere	there
yht	yet
yi	i
yiannis	diann's
yiew	view
yipee	yippee
yiu	you
yk	ya
yknow	know
yl	ya
ymi	mi
ymmv	ammo
ymptoms	symptoms
yms	yes
ymw	yaw
yn	in
yngeus	angels
yo's	yous
yoel	joel
yog	you
yoh	you
yoi	you
yoing	going
yolo	solo
yom	you
yoo	you
yoon	soon
yooo	yoko
yoooo	voodoo
yoosun	loosen
yor	you
yos	you
yosur	your
you'l	you'll
youch	touch
youd	you
youl	you
youll	you'll
your'e	you're
your're	you're
youre	your
yoursellf	yourself
yout	you
youtubed	youtube
youtubede	youtube
youtubers	youtube's
youtubes	youtube
youu	you
youuu	you
youve	you've
youz	you
yoy	you
yoyo	yoko
yoyos	boys
yoyu	you
ypu	you
yro	pro
ysob	sob
yu	you
yung	young
yuo	you
yupp	yup
yuppp	yuppy
yurp	burp
yurping	burping
yurps	burps
yuuup	yup
yvr	yer
yw	ya
yyc	you
yyyy	lyly
za	a
zabieg	babies
zac	zap
zacz	zach
zagen	hagen
zahra	zara
zainab	aintab
zal	pal
zat	at
ze	we
zeer	beer
zeg	beg
zeggen	begged
zei	zen
zeiden	leiden
zeit	zest
zeker	zeke
zelf	self
zelfde	elude
zelfs	tells
zenker's	zenger's
zenwise	unwise
zepbound	rebound
zet	get
zetje	pete
zetten	better
zevia	evil
zhang	hang
zhao	that
zhara	zara
zich	rich
zie	die
ziek	like
zien	zen
ziet	diet
zijn	zion
zin	in
zinda	kinda
zitten	bitten
zitti	ziti
zittoni	litton
ziylan	dylan
zkfb	kob
zmelo	smell
zna	na
znaj	snap
znale	name
zo	to
zo'n	zoon
zoals	goals
zodat	today
zodoc	zoo
zodra	odra
zoella	fella
zofrans	zofran
zoinkers	thinkers
zona	zone
zonder	wonder
zoolander	colander
zophran	cochran
zorbina	corina
zorgen	morgen
zou	you
zouden	louden
zover	over
zpk	pk
zpr	apr
zsm	ism
zt	it
zu	u
zuchinni	zucchini
zuck	fuck
zuerst	guest
zuf	zug
zul	zulu
zulin	ruin
zum	mum
zur	our
zurich	zürich
zuschuss	schuss
zwakke	wake
zwar	war
zypan	pan
zyrtecd	zyrtec
zyt	zit
